desc_distrito_local,desc_epigrafe,count_2015,count_2018,diff_perc,diff
ARGANZUELA,"ACABADO DE EDIFICIOS (CARPINTERIA, REVOCAMIENTO, REVESTIMIENTO DE SUELOS Y PAREDES,  PINTURA, ACRISTALAMIENTO)",18,25,38.88888888888889,7
ARGANZUELA,ACTIVIDADES ADMINISTRATIVAS Y AUXILIARES DE OFICINA Y SERVICIOS DE REPROGRAFIA,51,95,86.27450980392157,44
ARGANZUELA,ACTIVIDADES ANEXAS AL TRANSPORTE,14,13,-7.142857142857142,-1
ARGANZUELA,"ACTIVIDADES CINEMATOGRAFICAS, DE VIDEO Y DE TELEVISION (PRODUCCION, DISTRIBUCION Y EXHIBICION)",13,14,7.6923076923076925,1
ARGANZUELA,"ACTIVIDADES DE APOYO A LAS EMPRESAS N.C.O.P. (AGENCIAS DE COBROS, ENVASADO Y EMPAQUETADO)",1,1,0,0
ARGANZUELA,"ACTIVIDADES DE BIBLIOTECAS, ARCHIVOS, MUSEOS Y DE GALERIAS Y SALAS DE EXPOSICIONES SIN VENTA",9,9,0,0
ARGANZUELA,ACTIVIDADES DE CLUBES DEPORTIVOS Y OTRAS ACTIVIDADES DEPORTIVAS,4,2,-50,-2
ARGANZUELA,ACTIVIDADES DE CONSULTORIA DE GESTION EMPRESARIAL,7,4,-42.857142857142854,-3
ARGANZUELA,"ACTIVIDADES DE CONTABILIDAD, TENEDURIA, AUDITORIA Y ASESORIA FISCAL",32,31,-3.125,-1
ARGANZUELA,"ACTIVIDADES DE CREACION, ARTISTICAS Y ESPECTACULOS",12,15,25,3
ARGANZUELA,ACTIVIDADES DE DISEÑO ESPECIALIZADO,3,4,33.33333333333333,1
ARGANZUELA,ACTIVIDADES DE JARDINERIA,1,1,0,0
ARGANZUELA,ACTIVIDADES DE LAS AGENCIAS DE COLOCACION,1,1,0,0
ARGANZUELA,ACTIVIDADES DE LAS EMPRESAS DE TRABAJO TEMPORAL,4,4,0,0
ARGANZUELA,ACTIVIDADES DE LAS SEDES CENTRALES,4,10,150,6
ARGANZUELA,ACTIVIDADES DE LIMPIEZA,15,18,20,3
ARGANZUELA,ACTIVIDADES DE LOS GIMNASIOS,31,36,16.129032258064516,5
ARGANZUELA,ACTIVIDADES DE ORGANIZACIONES POLITICAS,5,7,40,2
ARGANZUELA,ACTIVIDADES DE ORGANIZACIONES RELIGIOSAS,23,25,8.695652173913043,2
ARGANZUELA,ACTIVIDADES DE SEGURIDAD PRIVADA,2,2,0,0
ARGANZUELA,ACTIVIDADES DE SERVICIOS SOCIALES SIN ALOJAMIENTO PARA PERSONAS MAYORES Y DISCAPACITADOS,21,24,14.285714285714285,3
ARGANZUELA,ACTIVIDADES DE TRADUCCION E INTERPRETACION,1,1,0,0
ARGANZUELA,ACTIVIDADES HOSPITALARIAS,1,1,0,0
ARGANZUELA,"ACTIVIDADES INMOBILIARIAS (COMPRAVENTA, ALQUILER, AGENTES PROPIEDAD)",54,61,12.962962962962962,7
ARGANZUELA,ACTIVIDADES JURIDICAS,5,2,-60,-3
ARGANZUELA,ADMINISTRACION PUBLICA Y DEFENSA. SEGURIDAD SOCIAL OBLIGATORIA,27,27,0,0
ARGANZUELA,"AGENCIAS DE VIAJES,  OPERADORES TURISTICOS Y SERVICIOS DE RESERVAS",32,35,9.375,3
ARGANZUELA,ALBERGUES JUVENILES Y OTROS ALOJAMIENTOS TURISTICOS DE CORTA ESTANCIA,1,1,0,0
ARGANZUELA,ALMACEN DE DISTRIBUCION POLIVALENTE A TEMPERATURA NO REGULADA,1,2,100,1
ARGANZUELA,ALQUILER DE BIENES INMOBILIARIOS POR CUENTA PROPIA,9,9,0,0
ARGANZUELA,ALQUILER DE EFECTOS PERSONALES Y ARTICULOS DE USO DOMESTICO,3,3,0,0
ARGANZUELA,ALQUILER DE VEHICULOS DE MOTOR,15,13,-13.333333333333334,-2
ARGANZUELA,ALQUILER MAQUINARIA Y EQUIPO DE CONSTRUCCION,2,1,-50,-1
ARGANZUELA,APARCAMIENTOS MIXTOS,2,2,0,0
ARGANZUELA,APARCAMIENTOS PRIVADOS,13,21,61.53846153846154,8
ARGANZUELA,APARCAMIENTOS PUBLICOS,16,18,12.5,2
ARGANZUELA,APART-HOTELES,1,2,100,1
ARGANZUELA,ARREGLO DE ROPA,23,28,21.73913043478261,5
ARGANZUELA,"ARRENDAMIENTO DE LA PROPIEDAD INTELECTUAL (USO DE MARCAS, PATENTES, FRANQUICIAS)",1,1,0,0
ARGANZUELA,"ASISTENCIA EN ESTABLECIMIENTOS RESIDENCIALES PARA MAYORES, DISCAPACITADOS, DROGODEPENDIENTES, CENTROS DE CONVALECENCIA, PERSONAS SIN HOGAR",15,18,20,3
ARGANZUELA,AUTOESCUELA,18,18,0,0
ARGANZUELA,AUTOSERVICIO DE RESTAURACION,4,5,25,1
ARGANZUELA,BAR CON COCINA,212,212,0,0
ARGANZUELA,BAR ESPECIAL CON ACTUACIONES,2,3,50,1
ARGANZUELA,BAR ESPECIAL SIN ACTUACIONES,28,24,-14.285714285714285,-4
ARGANZUELA,BAR RESTAURANTE,178,196,10.112359550561797,18
ARGANZUELA,BAR SIN COCINA,45,51,13.333333333333334,6
ARGANZUELA,CAFE ESPECTACULO,5,8,60,3
ARGANZUELA,CAFETERIA,135,149,10.37037037037037,14
ARGANZUELA,CAMBIO Y ENVIO DE MONEDA,16,14,-12.5,-2
ARGANZUELA,CARPINTERIA Y EBANISTERIA,3,4,33.33333333333333,1
ARGANZUELA,CENTRO DE EDUCACION DE PERSONAS ADULTAS (CEPA),1,3,200,2
ARGANZUELA,CENTRO DE ESTETICA,61,73,19.672131147540984,12
ARGANZUELA,CENTRO DE INFANTIL Y PRIMARIA PRIVADO,6,2,-66.66666666666666,-4
ARGANZUELA,CENTRO DE INFANTIL Y PRIMARIA PUBLICO,8,9,12.5,1
ARGANZUELA,"CENTRO DE PRIMARIA, SECUNDARIA, BACHILLERATO Y/O FP PRIVADO",2,3,50,1
ARGANZUELA,"CENTRO PRIV.CONCERTADO DE PRIMARIA, SECUND., BACHILL. Y/O FP",2,1,-50,-1
ARGANZUELA,"CENTRO PUBLICO DE SECUNDARIA, BACHILLERATO Y/O FP",2,2,0,0
ARGANZUELA,CENTROS DE BRONCEADO,17,16,-5.88235294117647,-1
ARGANZUELA,CENTROS DE FOTODEPILACION,11,21,90.9090909090909,10
ARGANZUELA,CENTROS DE JUEGOS O CELEBRACIONES INFANTILES CON COCINA,6,4,-33.33333333333333,-2
ARGANZUELA,CENTROS DE JUEGOS O CELEBRACIONES INFANTILES SIN COCINA,1,6,500,5
ARGANZUELA,CENTROS DE TATUAJE Y/O ANILLADO,3,6,100,3
ARGANZUELA,CENTROS PRIVADOS CONCERTADOS EDUC INFANTIL Y EDUC PRIMARIA,5,2,-60,-3
ARGANZUELA,CENTROS PUBLICOS DE EDUCACION PRIMARIA,3,4,33.33333333333333,1
ARGANZUELA,CHOCOLATERIA/SALON DE TE Y HELADERIA,3,4,33.33333333333333,1
ARGANZUELA,CLINICA VETERINARIA CON TRATAMIENTO HIGIENICO,17,16,-5.88235294117647,-1
ARGANZUELA,CLINICA VETERINARIA SIN TRATAMIENTO HIGIENICO,3,4,33.33333333333333,1
ARGANZUELA,CLINICAS MEDICAS,29,35,20.689655172413794,6
ARGANZUELA,COMERCIO AL MAYOR CON ALMACEN,4,4,0,0
ARGANZUELA,"COMERCIO AL POR MAYOR CARNES Y DERIVADOS, AVES Y CAZA",1,1,0,0
ARGANZUELA,COMERCIO AL POR MAYOR DE APARATOS ELECTRODOMESTICOS,2,2,0,0
ARGANZUELA,"COMERCIO AL POR MAYOR DE AZUCAR, CHOCOLATE Y CONFITERIA",1,1,0,0
ARGANZUELA,COMERCIO AL POR MAYOR DE BEBIDAS,1,1,0,0
ARGANZUELA,"COMERCIO AL POR MAYOR DE CAFE, TE, CACAO Y ESPECIAS",1,1,0,0
ARGANZUELA,"COMERCIO AL POR MAYOR DE COMBUSTIBLES, QUIMICOS Y PRODUCTOS SEMIELABORADOS",3,3,0,0
ARGANZUELA,COMERCIO AL POR MAYOR DE ENVASES Y EMBALAJES,1,1,0,0
ARGANZUELA,COMERCIO AL POR MAYOR DE INSTRUMENTOS MEDICOS Y ORTOPEDICOS,2,2,0,0
ARGANZUELA,COMERCIO AL POR MAYOR DE JUGUETES Y ARTICULOS DE DEPORTE,1,1,0,0
ARGANZUELA,"COMERCIO AL POR MAYOR DE LIBROS, PERIODICOS, REVISTAS, PAPELERIA Y ESCRITORIO",9,8,-11.11111111111111,-1
ARGANZUELA,"COMERCIO AL POR MAYOR DE MAQUINARIA, EQUIPO DE  OFICINA Y SUMINISTROS",35,31,-11.428571428571429,-4
ARGANZUELA,COMERCIO AL POR MAYOR DE MATERIAL Y APARATOS ELECTRONICOS PARA LAS TECNOLOGIAS DE LA INFORMACION Y LAS COMUNICACIONES,8,4,-50,-4
ARGANZUELA,"COMERCIO AL POR MAYOR DE METALES FERREOS Y NO FERREOS, MATERIAL DE CONSTRUCCION, PAPEL Y CARTON",9,9,0,0
ARGANZUELA,"COMERCIO AL POR MAYOR DE METALES PRECIOSOS, JOYERIA Y RELOJERIA",6,6,0,0
ARGANZUELA,COMERCIO AL POR MAYOR DE OTROS ARTICULOS DE USO DOMESTICO N.C.O.P.,8,8,0,0
ARGANZUELA,COMERCIO AL POR MAYOR DE OTROS PRODUCTOS ALIMENTICIOS,2,1,-50,-1
ARGANZUELA,"COMERCIO AL POR MAYOR DE PERFUMERIA,COSMETICA, DROGUERIA Y LIMPIEZA",6,6,0,0
ARGANZUELA,"COMERCIO AL POR MAYOR DE PORCELANA, CRISTALERIA Y ARTICULOS DE LIMPIEZA",4,4,0,0
ARGANZUELA,"COMERCIO AL POR MAYOR DE PRENDAS DE VESTIR, CALZADO Y ARTICULOS DE CUERO",6,5,-16.666666666666664,-1
ARGANZUELA,COMERCIO AL POR MAYOR DE PRODUCTOS FARMACEUTICOS,8,8,0,0
ARGANZUELA,"COMERCIO AL POR MAYOR FRUTAS, VERDURAS Y DERIVADOS",2,1,-50,-1
ARGANZUELA,"COMERCIO AL POR MENOR DE  PASTELERIA, CONFITERIA, REPOSTERIA CON OBRADOR-SIN BARRA DEGUSTACION",35,29,-17.142857142857142,-6
ARGANZUELA,"COMERCIO AL POR MENOR DE ALFOMBRAS, MOQUETAS Y REVESTIMIENTOS DE PAREDES Y SUELOS EN ESTABLECIMIENTOS ESPECIALIZADOS",8,8,0,0
ARGANZUELA,COMERCIO AL POR MENOR DE APARATOS DE ILUMINACION,2,2,0,0
ARGANZUELA,COMERCIO AL POR MENOR DE ARTICULOS DE FERRETERIA,30,28,-6.666666666666667,-2
ARGANZUELA,COMERCIO AL POR MENOR DE ARTICULOS DE PERFUMERIA Y COSMETICA,32,36,12.5,4
ARGANZUELA,COMERCIO AL POR MENOR DE ARTICULOS DE SEGUNDA MANO,11,9,-18.181818181818183,-2
ARGANZUELA,COMERCIO AL POR MENOR DE ARTICULOS DE USO DOMESTICO EN ESTABLECIMIENTO ESPECIALIZADO,14,15,7.142857142857142,1
ARGANZUELA,COMERCIO AL POR MENOR DE ARTICULOS DEPORTIVOS,15,14,-6.666666666666667,-1
ARGANZUELA,"COMERCIO AL POR MENOR DE AVES, HUEVOS Y CAZA CON OBRADOR",7,9,28.57142857142857,2
ARGANZUELA,"COMERCIO AL POR MENOR DE AVES, HUEVOS Y CAZA SIN OBRADOR",33,31,-6.0606060606060606,-2
ARGANZUELA,COMERCIO AL POR MENOR DE BICICLETAS,6,10,66.66666666666666,4
ARGANZUELA,"COMERCIO AL POR MENOR DE CAFE, INFUSIONES Y CHOCOLATE",3,4,33.33333333333333,1
ARGANZUELA,COMERCIO AL POR MENOR DE CALZADO Y ARTICULOS DE CUERO EN ESTABLECIMIENTOS ESPECIALIZADOS,42,44,4.761904761904762,2
ARGANZUELA,COMERCIO AL POR MENOR DE CARNICERIA,61,48,-21.311475409836063,-13
ARGANZUELA,COMERCIO AL POR MENOR DE CARNICERIA-CHARCUTERIA,9,7,-22.22222222222222,-2
ARGANZUELA,COMERCIO AL POR MENOR DE CARNICERIA-SALCHICHERIA,7,9,28.57142857142857,2
ARGANZUELA,COMERCIO AL POR MENOR DE CASQUERIA,6,4,-33.33333333333333,-2
ARGANZUELA,COMERCIO AL POR MENOR DE CHARCUTERIA,52,48,-7.6923076923076925,-4
ARGANZUELA,COMERCIO AL POR MENOR DE COLCHONERIA,10,8,-20,-2
ARGANZUELA,COMERCIO AL POR MENOR DE COMBUSTIBLE PARA LA AUTOMOCION EN ESTABLECIMIENTOS ESPECIALIZADOS,4,5,25,1
ARGANZUELA,COMERCIO AL POR MENOR DE CONGELADOS,56,41,-26.785714285714285,-15
ARGANZUELA,COMERCIO AL POR MENOR DE ELECTRODOMESTICOS,19,17,-10.526315789473683,-2
ARGANZUELA,COMERCIO AL POR MENOR DE EQUIPOS O APARATOS AUDIOVISUALES,3,1,-66.66666666666666,-2
ARGANZUELA,COMERCIO AL POR MENOR DE FRUTAS Y HORTALIZAS CON OBRADOR,11,9,-18.181818181818183,-2
ARGANZUELA,COMERCIO AL POR MENOR DE FRUTAS Y HORTALIZAS SIN OBRADOR,134,127,-5.223880597014925,-7
ARGANZUELA,COMERCIO AL POR MENOR DE FRUTOS SECOS Y VARIANTES,22,23,4.545454545454546,1
ARGANZUELA,COMERCIO AL POR MENOR DE GOLOSINAS,7,8,14.285714285714285,1
ARGANZUELA,COMERCIO AL POR MENOR DE HELADOS CON OBRADOR SIN BARRA DE DEGUSTACION,1,3,200,2
ARGANZUELA,COMERCIO AL POR MENOR DE HELADOS SIN OBRADOR,5,8,60,3
ARGANZUELA,COMERCIO AL POR MENOR DE INSTRUMENTOS MEDICOS Y ORTOPEDICOS,4,1,-75,-3
ARGANZUELA,COMERCIO AL POR MENOR DE INSTRUMENTOS MUSICALES,1,4,300,3
ARGANZUELA,"COMERCIO AL POR MENOR DE JOYAS, RELOJERIA Y BISUTERIA",34,30,-11.76470588235294,-4
ARGANZUELA,COMERCIO AL POR MENOR DE JUEGOS Y JUGUETES,7,7,0,0
ARGANZUELA,"COMERCIO AL POR MENOR DE LECHE, PRODUCTOS LACTEOS Y BEBIDAS REFRESCANTES",4,3,-25,-1
ARGANZUELA,COMERCIO AL POR MENOR DE LIBROS,12,10,-16.666666666666664,-2
ARGANZUELA,COMERCIO AL POR MENOR DE MAQUINARIA Y EQUIPOS DE OFICINA,2,2,0,0
ARGANZUELA,"COMERCIO AL POR MENOR DE MASAS Y PATATAS FRITAS, CHURRERIA CON OBRADOR",5,5,0,0
ARGANZUELA,COMERCIO AL POR MENOR DE MATERIAL DE OPTICA,31,33,6.451612903225806,2
ARGANZUELA,COMERCIO AL POR MENOR DE MATERIAL ELECTRICO,13,13,0,0
ARGANZUELA,COMERCIO AL POR MENOR DE MATERIAL ELECTRONICO,9,11,22.22222222222222,2
ARGANZUELA,COMERCIO AL POR MENOR DE MATERIAL FOTOGRAFICO Y FOTOGRAFIA,10,10,0,0
ARGANZUELA,COMERCIO AL POR MENOR DE MATERIALES DE CONSTRUCCION,8,10,25,2
ARGANZUELA,COMERCIO AL POR MENOR DE MENAJE DEL HOGAR,1,4,300,3
ARGANZUELA,COMERCIO AL POR MENOR DE MUEBLES,33,35,6.0606060606060606,2
ARGANZUELA,COMERCIO AL POR MENOR DE MUEBLES DE COCINA,14,14,0,0
ARGANZUELA,COMERCIO AL POR MENOR DE PAN Y PRODUCTOS DE PANADERIA Y BOLLERIA CON OBRADOR,71,64,-9.859154929577464,-7
ARGANZUELA,COMERCIO AL POR MENOR DE PAN Y PRODUCTOS DE PANADERIA Y BOLLERIA SIN OBRADOR,19,23,21.052631578947366,4
ARGANZUELA,"COMERCIO AL POR MENOR DE PASTELERIA, CONFITERIA, REPOSTERIA CON OBRADOR-BARRA DEGUSTACION",15,13,-13.333333333333334,-2
ARGANZUELA,"COMERCIO AL POR MENOR DE PASTELERIA, CONFITERIA, REPOSTERIA SIN OBRADOR",26,34,30.76923076923077,8
ARGANZUELA,"COMERCIO AL POR MENOR DE PERIODICOS, REVISTAS Y ARTICULOS DE PAPELERIA",31,28,-9.67741935483871,-3
ARGANZUELA,COMERCIO AL POR MENOR DE PESCADOS Y MARISCOS CON OBRADOR (INCLUYE COCCION),2,2,0,0
ARGANZUELA,COMERCIO AL POR MENOR DE PESCADOS Y MARISCOS SIN OBRADOR,56,47,-16.071428571428573,-9
ARGANZUELA,COMERCIO AL POR MENOR DE PRENDAS DE VESTIR EN ESTABLECIMIENTOS ESPECIALIZADOS,102,97,-4.901960784313726,-5
ARGANZUELA,COMERCIO AL POR MENOR DE PRODUCTOS ALIMENTICIOS NO PERECEDEROS ENVASADOS,26,40,53.84615384615385,14
ARGANZUELA,"COMERCIO AL POR MENOR DE PRODUCTOS AUDIOVISUALES EN ESTABLECIMIENTOS ESPECIALIZADOS (CD,DVD,â¦)",4,4,0,0
ARGANZUELA,COMERCIO AL POR MENOR DE PRODUCTOS DE DROGUERIA,8,11,37.5,3
ARGANZUELA,COMERCIO AL POR MENOR DE PRODUCTOS DE HERBOLARIO,23,21,-8.695652173913043,-2
ARGANZUELA,"COMERCIO AL POR MENOR DE PRODUCTOS DE PRECIO UNICO, BAZARES Y ASIMILABLES",71,66,-7.042253521126761,-5
ARGANZUELA,COMERCIO AL POR MENOR DE PRODUCTOS DE TELEFONIA Y TELECOMUNICACIONES,38,37,-2.631578947368421,-1
ARGANZUELA,COMERCIO AL POR MENOR DE PRODUCTOS PARAFARMACEUTICOS,2,1,-50,-1
ARGANZUELA,"COMERCIO AL POR MENOR DE PUERTAS, VENTANAS Y PERSIANAS",15,16,6.666666666666667,1
ARGANZUELA,COMERCIO AL POR MENOR DE SANEAMIENTOS,6,8,33.33333333333333,2
ARGANZUELA,"COMERCIO AL POR MENOR DE SELLOS, MONEDAS Y MEDALLAS",1,1,0,0
ARGANZUELA,"COMERCIO AL POR MENOR DE SEMILLAS, ABONOS, PLANTAS Y FLOR CORTADA",16,22,37.5,6
ARGANZUELA,COMERCIO AL POR MENOR DE TABACOS Y ARTICULOS DE FUMADOR,32,34,6.25,2
ARGANZUELA,COMERCIO AL POR MENOR DE TEXTILES PARA EL HOGAR,31,29,-6.451612903225806,-2
ARGANZUELA,COMERCIO AL POR MENOR DE VINOS Y ALCOHOLES (BODEGA) CON CONSUMO,5,4,-20,-1
ARGANZUELA,COMERCIO AL POR MENOR DE VINOS Y ALCOHOLES (BODEGA) SIN CONSUMO,3,5,66.66666666666666,2
ARGANZUELA,"COMERCIO AL POR MENOR EN ESTABLECIMIENTOS NO ESPECIALIZADOS, CON PREDOMINIO EN PRODUCTOS ALIMENTICIOS, BEBIDAS Y TABACO (AUTOSERVICIO)",140,160,14.285714285714285,20
ARGANZUELA,"COMERCIO AL POR MENOR EN ESTABLECIMIENTOS NO ESPECIALIZADOS, CON PREDOMINIO EN PRODUCTOS ALIMENTICIOS, BEBIDAS Y TABACO (GRANDES SUPERFICIES)",9,1,-88.88888888888889,-8
ARGANZUELA,"COMERCIO AL POR MENOR EN ESTABLECIMIENTOS NO ESPECIALIZADOS, SIN PREDOMINIO EN PRODUCTOS ALIMENTICIOS, BEBIDAS Y TABACO",5,8,60,3
ARGANZUELA,COMERCIO AL POR MENOR EN TIENDAS DE BRICOLAJE,4,4,0,0
ARGANZUELA,"COMERCIO AL POR MENOR POR CORRESPONDENCIA, INTERNET, A DOMICILIO",5,6,20,1
ARGANZUELA,COMERCIO DE RESPUESTOS Y ACCESORIOS DE VEHICULOS DE MOTOR,17,17,0,0
ARGANZUELA,COMERCIO DE VEHICULOS DE MOTOR NUEVOS,21,18,-14.285714285714285,-3
ARGANZUELA,COMERCIO DE VEHICULOS DE MOTOR USADOS,11,11,0,0
ARGANZUELA,CONFECCION PRENDAS DE VESTIR (INCLUIDO CUERO Y EXCLUIDA LA PELETERIA Y LAS PRENDAS DE PUNTO),5,6,20,1
ARGANZUELA,CONSTRUCCION DE EDIFICIOS,12,10,-16.666666666666664,-2
ARGANZUELA,CONSULTA DE ESTOMATOLOGOS Y ODONTOLOGOS,30,37,23.333333333333332,7
ARGANZUELA,CONSULTA DE MEDICINA GENERAL Y ESPECIALIDADES,13,16,23.076923076923077,3
ARGANZUELA,CONSULTA DE OPTICOS-OPTOMETRISTAS,4,5,25,1
ARGANZUELA,CONSULTA DE PODOLOGIA,9,10,11.11111111111111,1
ARGANZUELA,CONSULTA DE PROTESICOS E HIGIENISTAS DENTALES,10,15,50,5
ARGANZUELA,CONSULTORIO VETERINARIO CON TRATAMIENTO HIGIENICO ANIMAL,3,2,-33.33333333333333,-1
ARGANZUELA,"CORTE, TALLADO Y ACABADO DE LA PIEDRA",1,1,0,0
ARGANZUELA,DEPOSITO Y ALMACENAMIENTO,33,42,27.27272727272727,9
ARGANZUELA,DESPACHO DE FISIOTERAPEUTAS,7,10,42.857142857142854,3
ARGANZUELA,DESPACHO DE PROTESICOS E HIGIENISTAS DENTALES,2,4,100,2
ARGANZUELA,DESPACHO MEDICO DE MEDICINA GENERAL Y ESPECIALISTAS,1,4,300,3
ARGANZUELA,"DESPACHO PROFESIONAL DE ACTIVIDADES ECONOMICAS (CONTABILIDAD, AUDITORIA Y ASESORIA FISCAL)",6,6,0,0
ARGANZUELA,DESPACHO PROFESIONAL DE ACTIVIDADES JURIDICAS,4,8,100,4
ARGANZUELA,DESPACHO PROFESIONAL DE ARQUITECTURA E INGENIERIA,3,6,100,3
ARGANZUELA,DISCOTECAS Y SALAS DE BAILE,2,2,0,0
ARGANZUELA,"EDICION DE LIBROS, PERIODICOS Y OTRAS ACTIVIDADES EDITORIALES",6,4,-33.33333333333333,-2
ARGANZUELA,EDICION DE PROGRAMAS INFORMATICOS,1,1,0,0
ARGANZUELA,EDUCACION TERCIARIA NO UNIVERSITARIA,1,1,0,0
ARGANZUELA,EDUCACION UNIVERSITARIA PRIVADA,2,2,0,0
ARGANZUELA,EDUCACION UNIVERSITARIA PUBLICA,1,1,0,0
ARGANZUELA,ENCUADERNACION Y SERVICIOS RELACIONADOS CON LA MISMA,3,5,66.66666666666666,2
ARGANZUELA,ENSEÑANZA DE IDIOMAS,11,13,18.181818181818183,2
ARGANZUELA,"ENSEÑANZA NO REGLADA (DEPORTIVA Y RECREATIVA, CULTURAL, CLASES DE RECUPERACION, INFORMATICA)",82,119,45.1219512195122,37
ARGANZUELA,ESTABLECIMIENTOS DE VENTA DE PLATOS PREPARADOS CON OBRADOR,19,22,15.789473684210526,3
ARGANZUELA,ESTABLECIMIENTOS DE VENTA DE PLATOS PREPARADOS SIN OBRADOR,1,2,100,1
ARGANZUELA,EXTRACCION DE CRUDO DE PETROLEO Y GAS NATURAL,1,1,0,0
ARGANZUELA,"FABRICACION DE APARATOS ELECTRICOS, ELECTRODOMESTICOS (EXCEPTO ORDENADORES)",3,2,-33.33333333333333,-1
ARGANZUELA,"FABRICACION DE ARTICULOS DE JOYERIA, BISUTERIA Y SIMILARES",1,3,200,2
ARGANZUELA,FABRICACION DE HIELO Y SUMINISTRO DE VAPOR Y AIRE ACONDICIONADO,1,1,0,0
ARGANZUELA,"FABRICACION DE INSTRUMENTOS DE PRECISION, MEDIDA Y CONTROL. FABRICACION DE RELOJES",1,1,0,0
ARGANZUELA,FABRICACION DE INSTRUMENTOS Y SUMINISTROS MEDICOS Y ODONTOLOGICOS,5,5,0,0
ARGANZUELA,FABRICACION DE MATERIAL Y EQUIPO ELECTRICO (EXCEPTO ORDENADORES),1,1,0,0
ARGANZUELA,"FABRICACION DE PINTURAS, BARNICES, LACAS Y REVESTIMIENTOS SIMILARES",2,3,50,1
ARGANZUELA,FABRICACION DE PRODUCTOS DE CAUCHO Y PLASTICOS,1,1,0,0
ARGANZUELA,FABRICACION DE PRODUCTOS DE PANADERIA Y PASTELERIA,3,2,-33.33333333333333,-1
ARGANZUELA,"FABRICACION DE PRODUCTOS METALICOS, EXCEPTO MAQUINARIA Y EQUIPO",1,1,0,0
ARGANZUELA,"FABRICACION DE TEJIDOS TEXTILES, ALFOMBRAS, CUERDAS Y OTROS PRODUCTOS TEXTILES (EXCEPTO PRENDAS DE VESTIR)",2,1,-50,-1
ARGANZUELA,FARMACIA,78,78,0,0
ARGANZUELA,FISIOTERAPEUTAS Y OTRAS ACTIVIDADES SANITARIAS,29,42,44.827586206896555,13
ARGANZUELA,GESTION DE INSTALACIONES DEPORTIVAS,4,4,0,0
ARGANZUELA,HOTELES Y MOTELES CON RESTAURANTE,7,11,57.14285714285714,4
ARGANZUELA,IMPRENTA,9,9,0,0
ARGANZUELA,"INDUSTRIA DE LA MADERA Y CORCHO (EXCEPTO MUEBLES), CESTERIA Y ESPARTERIA",10,7,-30,-3
ARGANZUELA,INDUSTRIAS MANUFACTURERAS N.C.O.P.,2,2,0,0
ARGANZUELA,INGENIERIA CIVIL,5,4,-20,-1
ARGANZUELA,INSTALACION DE MAQUINAS Y EQUIPOS INDUSTRIALES,3,2,-33.33333333333333,-1
ARGANZUELA,"INSTALACIONES ELECTRICAS, DE FONTANERIA Y OTRAS EN OBRAS DE CONSTRUCCION",63,66,4.761904761904762,3
ARGANZUELA,INSTITUTO DE BELLEZA,10,9,-10,-1
ARGANZUELA,"INTERMEDIACION MONETARIA: BANCOS, CAJAS DE AHORRO",138,112,-18.84057971014493,-26
ARGANZUELA,"INTERMEDIARIO DEL COMERCIO DE PRODUCTOS ALIMENTICIOS, BEBIDAS Y TABACO",1,1,0,0
ARGANZUELA,"INTERMEDIARIOS DEL COMERCIO DE COMBUSTIBLES, MINERALES, METALES Y PRODUCTOS QUIMICOS INDUSTRIALES",1,1,0,0
ARGANZUELA,INTERMEDIARIOS DEL COMERCIO DE LA MADERA Y MATERIALES DE CONSTRUCCION,2,3,50,1
ARGANZUELA,"INTERMEDIARIOS DEL COMERCIO DE MAQUINARIA, EQUIPO INDUSTRIAL, EMBARCACIONES Y AERONAVES",3,3,0,0
ARGANZUELA,INTERMEDIARIOS DEL COMERCIO DE MUEBLES,2,2,0,0
ARGANZUELA,"INTERMEDIARIOS DEL COMERCIO DE TEXTILES, PRENDAS DE VESTIR, PELETERIA, CALZADO Y ARTICULOS DE CUERO",6,6,0,0
ARGANZUELA,INTERMEDIARIOS DEL COMERCIO ESPECIALIZADOS EN LA VENTA DE OTROS PRODUCTOS ESPECIFICOS,1,1,0,0
ARGANZUELA,"INVERSION COLECTIVA, FONDOS Y ENTIDADES FINANCIERAS SIMILARES",1,1,0,0
ARGANZUELA,INVESTIGACION Y DESARROLLO,1,1,0,0
ARGANZUELA,"JUEGOS DE AZAR Y APUESTAS DE GESTION PRIVADA (BINGOS, CASINOS, MAQUINAS TRAGAPERRAS)",13,21,61.53846153846154,8
ARGANZUELA,JUEGOS DE AZAR Y APUESTAS DE GESTION PUBLICA O O AUTORIZACION ESPECIAL (ESTADO Y ONCE),23,23,0,0
ARGANZUELA,LAVADO Y LIMPIEZA DE PRENDAS TEXTILES Y DE PIEL,32,31,-3.125,-1
ARGANZUELA,LOCAL SIN ACTIVIDAD,5,34,580,29
ARGANZUELA,LOCALES DE EXHIBICIONES EROTICAS,1,1,0,0
ARGANZUELA,LOCUTORIOS,74,65,-12.162162162162163,-9
ARGANZUELA,"MANTENIMIENTO Y REPARACION DE MAQUINARIA Y EQUIPO, INCLUIDO EL FERROVIARIO",6,6,0,0
ARGANZUELA,MANTENIMIENTO Y REPARACION DE MOTOCICLETAS Y VENTA DE SUS REPUESTOS Y ACCESORIOS,8,8,0,0
ARGANZUELA,MANTENIMIENTO Y REPARACION DE VEHICULOS DE MOTOR N.C.O.P.,10,9,-10,-1
ARGANZUELA,"METALURGIA. FABRICACION DE PRODUCTOS DE HIERRO, ACERO Y FERROALEACIONES",1,1,0,0
ARGANZUELA,ORGANIZACION DE CONVENCIONES Y FERIAS DE MUESTRAS,2,3,50,1
ARGANZUELA,OTRAS ACTIVIDADES ASOCIATIVAS N.C.O.P.,27,33,22.22222222222222,6
ARGANZUELA,"OTRAS ACTIVIDADES DE CONSTRUCCION ESPECIALIZADA (CONSTRUCCION DE CUBIERTAS, CIMENTACION, PISCINAS)",19,18,-5.263157894736842,-1
ARGANZUELA,"OTRAS ACTIVIDADES PROFESIONALES, CIENTIFICAS Y TECNICAS N.C.O.P.",8,12,50,4
ARGANZUELA,"OTRAS SERVICIOS PERSONALES (ASTROLOGIA, AGENCIAS DE CONTACTOS) N.C.O.P.",2,3,50,1
ARGANZUELA,OTRO COMERCIO AL POR MENOR DE PRODUCTOS ALIMENTICIOS (PERECEDEROS Y NO PERECEDEROS) CON VENDEDOR N.C.O.P.,47,53,12.76595744680851,6
ARGANZUELA,OTRO COMERCIO AL POR MENOR DEL ARTICULOS NUEVOS N.C.O.P.,23,26,13.043478260869565,3
ARGANZUELA,OTROS ACTIVIDADES DE SERVICIOS SOCIALES (LABORES DE ASESORAMIENTO Y ORIENTACION) SIN ALOJAMIENTO N.C.O.P.,13,14,7.6923076923076925,1
ARGANZUELA,"OTROS SERVICIOS DE COMIDAS EN INSTALACIONES DEPORTIVAS, OFICINAS, EMPRESAS O SIMILARES",1,3,200,2
ARGANZUELA,OTROS SERVICIOS DE INFORMACION: AGENCIAS DE NOTICIAS,1,1,0,0
ARGANZUELA,"OTROS SERVICIOS FINANCIEROS(ARRENDAMIENTO FINANCIERO, PRESTAMOS POR ENTIDADES NO FINANCIERAS), EXCEPTO SEGUROS Y FONDOS DE PENSIONES",1,1,0,0
ARGANZUELA,"PARQUES ZOOLOGICOS, JARDINES BOTANICOS Y RESERVAS NATURALES",1,1,0,0
ARGANZUELA,"PROCESADO Y CONSERVACION DE CARNE Y ELABORACION DE PRODUCTOS CARNICOS, AVES Y CAZA",1,1,0,0
ARGANZUELA,"PRODUCCION, TRANSPORTE Y DISTRIBUCION DE ENERGIA ELECTRICA Y GAS",5,4,-20,-1
ARGANZUELA,PROGRAMACION Y CONSULTORIA INFORMATICA Y TECNOLOGIAS DE LA INFORMACION,7,6,-14.285714285714285,-1
ARGANZUELA,PROMOCION INMOBILIARIA,19,16,-15.789473684210526,-3
ARGANZUELA,"PUBLICIDAD, RELACIONES PUBLICAS Y ESTUDIOS DE MERCADO",4,4,0,0
ARGANZUELA,REPARACION DE CALZADO,20,18,-10,-2
ARGANZUELA,REPARACION DE ORDENADORES Y EQUIPOS DE COMUNICACION,13,10,-23.076923076923077,-3
ARGANZUELA,REPARACION DE OTROS EFECTOS PERSONALES Y ARTICULOS DE USO DOMESTICO N.C.O.P.,15,18,20,3
ARGANZUELA,RESTAURANTE,104,109,4.807692307692308,5
ARGANZUELA,RESTAURANTES DE COMIDA RAPIDA,34,36,5.88235294117647,2
ARGANZUELA,SALA DE EXPOSICIONES Y GALERIAS DE ARTE CON VENTA,3,3,0,0
ARGANZUELA,SALAS DE FIESTA SIN RESTAURACION,1,3,200,2
ARGANZUELA,SALONES DE RECREO Y DIVERSION Y OTRAS ACTIVIDADES RECREATIVAS,9,9,0,0
ARGANZUELA,SEGUROS,17,18,5.88235294117647,1
ARGANZUELA,SERIGRAFIA Y SERVICIOS DE PREIMPRESION Y PREPARACION DE SOPORTES,2,3,50,1
ARGANZUELA,SERVICIO DE PELUQUERIA,231,238,3.0303030303030303,7
ARGANZUELA,"SERVICIOS DE INFORMACION: PROCESO DE DATOS, PORTALES WEB",1,2,100,1
ARGANZUELA,"SERVICIOS DE MENSAJERIA, ACTIVIDADES POSTALES Y DE CORREOS",16,16,0,0
ARGANZUELA,SERVICIOS DE SISTEMAS DE SEGURIDAD: VIGILANCIA MEDIANTE SISTEMAS ELECTRONICOS,4,4,0,0
ARGANZUELA,SERVICIOS FOTOGRAFICOS,7,9,28.57142857142857,2
ARGANZUELA,SERVICIOS INTEGRALES A EDIFICIOS E INSTALACIONES,3,2,-33.33333333333333,-1
ARGANZUELA,"SERVICIOS PARASANITARIOS (NATUROPATIA, ACUPUNTURA, HOMEOPATIA)",10,14,40,4
ARGANZUELA,SERVICIOS TECNICOS DE ARQUITECTURA E INGENIERIA. ENSAYOS Y ANALISIS TECNICOS,23,21,-8.695652173913043,-2
ARGANZUELA,SEX-SHOP,1,1,0,0
ARGANZUELA,SITUADOS: CONFITERIA Y FRUTOS SECOS Y PATATAS FRITAS,1,2,100,1
ARGANZUELA,TABERNA,10,9,-10,-1
ARGANZUELA,TALLER DE MONTAJE DE ACCESORIOS PARA EL AUTOMOVIL,7,6,-14.285714285714285,-1
ARGANZUELA,TALLER DE REPARACION DE AUTOMOVILES ESPECIALIZADO EN CHAPA Y PINTURA,7,8,14.285714285714285,1
ARGANZUELA,TALLER DE REPARACION DE AUTOMOVILES ESPECIALIZADO EN MECANICA Y ELECTRICIDAD,32,33,3.125,1
ARGANZUELA,TAPICERIA,5,5,0,0
ARGANZUELA,TEATRO Y ACTIVIDADES ESCENICAS REALIZADAS EN DIRECTO,5,5,0,0
ARGANZUELA,TELECOMUNICACIONES,6,8,33.33333333333333,2
ARGANZUELA,TIENDA DE CONVENIENCIA (24H),2,2,0,0
ARGANZUELA,TRANSPORTE DE MERCANCIAS POR CARRETERA Y SERVICIOS DE MUDANZAS,9,8,-11.11111111111111,-1
ARGANZUELA,TRANSPORTE INTERURBANO DE PASAJEROS POR FERROCARRIL,4,4,0,0
ARGANZUELA,"TRANSPORTE TERRESTRE URBANO (AUTOBUS, METRO, TAXI) O INTERURBANO (EXCEPTO POR FERROCARRIL)",34,33,-2.941176470588235,-1
ARGANZUELA,TRATAMIENTO HIGIENICO DE ANIMALES (PELUQUERIAS),9,11,22.22222222222222,2
ARGANZUELA,VENDEDOR AMBULANTE DE ALIMENTOS PREPARADOS PARA SU CONSUMO INMEDIATO,1,1,0,0
ARGANZUELA,VENTA DE MOTOCICLETAS,10,9,-10,-1
ARGANZUELA,VIDEOCLUB,3,2,-33.33333333333333,-1
ARGANZUELA,NA,6,12,100,6
CENTRO,"ACABADO DE EDIFICIOS (CARPINTERIA, REVOCAMIENTO, REVESTIMIENTO DE SUELOS Y PAREDES,  PINTURA, ACRISTALAMIENTO)",9,12,33.33333333333333,3
CENTRO,ACTIVIDADES ADMINISTRATIVAS Y AUXILIARES DE OFICINA Y SERVICIOS DE REPROGRAFIA,59,124,110.16949152542372,65
CENTRO,ACTIVIDADES ANEXAS AL TRANSPORTE,13,12,-7.6923076923076925,-1
CENTRO,ACTIVIDADES AUXILIARES A SEGUROS Y FONDOS DE PENSIONES,4,4,0,0
CENTRO,"ACTIVIDADES CINEMATOGRAFICAS, DE VIDEO Y DE TELEVISION (PRODUCCION, DISTRIBUCION Y EXHIBICION)",16,18,12.5,2
CENTRO,"ACTIVIDADES DE APOYO A LAS EMPRESAS N.C.O.P. (AGENCIAS DE COBROS, ENVASADO Y EMPAQUETADO)",1,2,100,1
CENTRO,"ACTIVIDADES DE BIBLIOTECAS, ARCHIVOS, MUSEOS Y DE GALERIAS Y SALAS DE EXPOSICIONES SIN VENTA",38,37,-2.631578947368421,-1
CENTRO,ACTIVIDADES DE CLUBES DEPORTIVOS Y OTRAS ACTIVIDADES DEPORTIVAS,3,2,-33.33333333333333,-1
CENTRO,ACTIVIDADES DE CONSULTORIA DE GESTION EMPRESARIAL,5,5,0,0
CENTRO,"ACTIVIDADES DE CONTABILIDAD, TENEDURIA, AUDITORIA Y ASESORIA FISCAL",18,17,-5.555555555555555,-1
CENTRO,"ACTIVIDADES DE CREACION, ARTISTICAS Y ESPECTACULOS",42,46,9.523809523809524,4
CENTRO,ACTIVIDADES DE DISEÑO ESPECIALIZADO,23,25,8.695652173913043,2
CENTRO,ACTIVIDADES DE GESTION DE FONDOS,1,1,0,0
CENTRO,ACTIVIDADES DE GRABACION DE SONIDO Y EDICION MUSICAL,3,4,33.33333333333333,1
CENTRO,ACTIVIDADES DE LAS AGENCIAS DE COLOCACION,2,1,-50,-1
CENTRO,ACTIVIDADES DE LAS EMPRESAS DE TRABAJO TEMPORAL,2,1,-50,-1
CENTRO,ACTIVIDADES DE LAS SEDES CENTRALES,5,7,40,2
CENTRO,ACTIVIDADES DE LIMPIEZA,9,8,-11.11111111111111,-1
CENTRO,ACTIVIDADES DE LOS GIMNASIOS,36,37,2.7777777777777777,1
CENTRO,ACTIVIDADES DE ORGANIZACIONES POLITICAS,4,6,50,2
CENTRO,ACTIVIDADES DE ORGANIZACIONES RELIGIOSAS,78,75,-3.8461538461538463,-3
CENTRO,ACTIVIDADES DE ORGANIZACIONES Y ORGANISMOS EXTRATERRITORIALES,2,2,0,0
CENTRO,ACTIVIDADES DE SEGURIDAD PRIVADA,1,1,0,0
CENTRO,ACTIVIDADES DE SERVICIOS SOCIALES SIN ALOJAMIENTO PARA PERSONAS MAYORES Y DISCAPACITADOS,26,9,-65.38461538461539,-17
CENTRO,ACTIVIDADES HOSPITALARIAS,3,3,0,0
CENTRO,"ACTIVIDADES INMOBILIARIAS (COMPRAVENTA, ALQUILER, AGENTES PROPIEDAD)",26,42,61.53846153846154,16
CENTRO,ACTIVIDADES JURIDICAS,12,13,8.333333333333332,1
CENTRO,"ADMINISTRACION DE MERCADOS FINANCIEROS, INTERMEDIACION EN OPERACIONES CON VALORES Y OTROS ACTIVOS",1,1,0,0
CENTRO,ADMINISTRACION PUBLICA Y DEFENSA. SEGURIDAD SOCIAL OBLIGATORIA,111,107,-3.6036036036036037,-4
CENTRO,"AGENCIAS DE VIAJES,  OPERADORES TURISTICOS Y SERVICIOS DE RESERVAS",56,53,-5.357142857142857,-3
CENTRO,ALBERGUES JUVENILES Y OTROS ALOJAMIENTOS TURISTICOS DE CORTA ESTANCIA,4,10,150,6
CENTRO,ALMACEN DE DISTRIBUCION DE PRODUCTOS ALIMENTICIOS,2,4,100,2
CENTRO,ALMACEN DE DISTRIBUCION POLIVALENTE A TEMPERATURA NO REGULADA,3,3,0,0
CENTRO,ALQUILER DE BIENES INMOBILIARIOS POR CUENTA PROPIA,7,4,-42.857142857142854,-3
CENTRO,ALQUILER DE EFECTOS PERSONALES Y ARTICULOS DE USO DOMESTICO,7,7,0,0
CENTRO,ALQUILER DE VEHICULOS DE MOTOR,7,8,14.285714285714285,1
CENTRO,APARCAMIENTOS MIXTOS,3,6,100,3
CENTRO,APARCAMIENTOS PRIVADOS,15,18,20,3
CENTRO,APARCAMIENTOS PUBLICOS,39,36,-7.6923076923076925,-3
CENTRO,APART-HOTELES,5,17,240,12
CENTRO,ARREGLO DE ROPA,29,31,6.896551724137931,2
CENTRO,AUTOESCUELA,11,14,27.27272727272727,3
CENTRO,AUTOSERVICIO DE RESTAURACION,1,3,200,2
CENTRO,BAR CON COCINA,272,325,19.485294117647058,53
CENTRO,BAR ESPECIAL CON ACTUACIONES,24,28,16.666666666666664,4
CENTRO,BAR ESPECIAL SIN ACTUACIONES,259,252,-2.7027027027027026,-7
CENTRO,BAR RESTAURANTE,515,661,28.349514563106798,146
CENTRO,BAR SIN COCINA,231,249,7.792207792207792,18
CENTRO,CAFE ESPECTACULO,17,27,58.82352941176471,10
CENTRO,CAFETERIA,535,533,-0.3738317757009346,-2
CENTRO,CAMBIO Y ENVIO DE MONEDA,13,24,84.61538461538461,11
CENTRO,"CAPTACION, DEPURACION Y DISTRIBUCION DE AGUA",1,1,0,0
CENTRO,CARPINTERIA Y EBANISTERIA,4,4,0,0
CENTRO,CASAS DE HUESPEDES,3,7,133.33333333333331,4
CENTRO,CENTRO DE ESTETICA,54,94,74.07407407407408,40
CENTRO,CENTRO DE INFANTIL Y PRIMARIA PRIVADO,2,2,0,0
CENTRO,CENTRO DE INFANTIL Y PRIMARIA PUBLICO,8,8,0,0
CENTRO,"CENTRO DE PRIMARIA, SECUNDARIA, BACHILLERATO Y/O FP PRIVADO",3,4,33.33333333333333,1
CENTRO,"CENTRO PRIV.CONCERTADO DE PRIMARIA, SECUND., BACHILL. Y/O FP",5,4,-20,-1
CENTRO,"CENTRO PUBLICO DE SECUNDARIA, BACHILLERATO Y/O FP",7,7,0,0
CENTRO,CENTROS DE BRONCEADO,17,12,-29.411764705882355,-5
CENTRO,CENTROS DE FOTODEPILACION,3,3,0,0
CENTRO,CENTROS DE JUEGOS O CELEBRACIONES INFANTILES CON COCINA,1,1,0,0
CENTRO,CENTROS DE TATUAJE Y/O ANILLADO,31,38,22.58064516129032,7
CENTRO,CENTROS PRIVADOS CONCERTADOS DE EDUCACION PRIMARIA,1,1,0,0
CENTRO,CENTROS PRIVADOS CONCERTADOS EDUC INFANTIL Y EDUC PRIMARIA,5,5,0,0
CENTRO,CENTROS PRIVADOS DE EDUCACION PRIMARIA,1,1,0,0
CENTRO,CENTROS PUBLICOS DE EDUCACION PRIMARIA,1,2,100,1
CENTRO,CHOCOLATERIA/SALON DE TE Y HELADERIA,33,26,-21.21212121212121,-7
CENTRO,CIBER-CAFE,1,1,0,0
CENTRO,CLINICA VETERINARIA CON TRATAMIENTO HIGIENICO,7,7,0,0
CENTRO,CLINICA VETERINARIA SIN TRATAMIENTO HIGIENICO,3,5,66.66666666666666,2
CENTRO,CLINICAS MEDICAS,12,13,8.333333333333332,1
CENTRO,COLEGIOS MAYORES Y RESIDENCIAS DE ESTUDIANTES,2,2,0,0
CENTRO,COMERCIO AL MAYOR CON ALMACEN,2,2,0,0
CENTRO,"COMERCIO AL POR MAYOR CARNES Y DERIVADOS, AVES Y CAZA",4,3,-25,-1
CENTRO,COMERCIO AL POR MAYOR DE APARATOS ELECTRODOMESTICOS,2,1,-50,-1
CENTRO,"COMERCIO AL POR MAYOR DE AZUCAR, CHOCOLATE Y CONFITERIA",2,2,0,0
CENTRO,COMERCIO AL POR MAYOR DE BEBIDAS,2,3,50,1
CENTRO,"COMERCIO AL POR MAYOR DE CAFE, TE, CACAO Y ESPECIAS",1,2,100,1
CENTRO,"COMERCIO AL POR MAYOR DE COMBUSTIBLES, QUIMICOS Y PRODUCTOS SEMIELABORADOS",1,1,0,0
CENTRO,COMERCIO AL POR MAYOR DE ENVASES Y EMBALAJES,4,4,0,0
CENTRO,COMERCIO AL POR MAYOR DE INSTRUMENTOS MEDICOS Y ORTOPEDICOS,3,3,0,0
CENTRO,COMERCIO AL POR MAYOR DE JUGUETES Y ARTICULOS DE DEPORTE,5,4,-20,-1
CENTRO,COMERCIO AL POR MAYOR DE LECHE Y DERIVADOS,2,2,0,0
CENTRO,"COMERCIO AL POR MAYOR DE LIBROS, PERIODICOS, REVISTAS, PAPELERIA Y ESCRITORIO",8,8,0,0
CENTRO,"COMERCIO AL POR MAYOR DE MAQUINARIA, EQUIPO DE  OFICINA Y SUMINISTROS",5,5,0,0
CENTRO,COMERCIO AL POR MAYOR DE MATERIAL Y APARATOS ELECTRONICOS PARA LAS TECNOLOGIAS DE LA INFORMACION Y LAS COMUNICACIONES,12,6,-50,-6
CENTRO,"COMERCIO AL POR MAYOR DE METALES FERREOS Y NO FERREOS, MATERIAL DE CONSTRUCCION, PAPEL Y CARTON",4,4,0,0
CENTRO,"COMERCIO AL POR MAYOR DE METALES PRECIOSOS, JOYERIA Y RELOJERIA",29,27,-6.896551724137931,-2
CENTRO,COMERCIO AL POR MAYOR DE OTROS ARTICULOS DE USO DOMESTICO N.C.O.P.,40,36,-10,-4
CENTRO,COMERCIO AL POR MAYOR DE OTROS PRODUCTOS ALIMENTICIOS,3,4,33.33333333333333,1
CENTRO,"COMERCIO AL POR MAYOR DE PERFUMERIA,COSMETICA, DROGUERIA Y LIMPIEZA",13,13,0,0
CENTRO,"COMERCIO AL POR MAYOR DE PORCELANA, CRISTALERIA Y ARTICULOS DE LIMPIEZA",3,3,0,0
CENTRO,"COMERCIO AL POR MAYOR DE PRENDAS DE VESTIR, CALZADO Y ARTICULOS DE CUERO",200,135,-32.5,-65
CENTRO,COMERCIO AL POR MAYOR DE PRODUCTOS DE LA PESCA Y MARISCOS (EXCEPTO CONGELADOS),3,2,-33.33333333333333,-1
CENTRO,COMERCIO AL POR MAYOR DE TEXTILES,54,45,-16.666666666666664,-9
CENTRO,"COMERCIO AL POR MAYOR FRUTAS, VERDURAS Y DERIVADOS",2,1,-50,-1
CENTRO,COMERCIO AL POR MENOR CON MAQUINAS EXPENDEDORAS,6,6,0,0
CENTRO,"COMERCIO AL POR MENOR DE  PASTELERIA, CONFITERIA, REPOSTERIA CON OBRADOR-SIN BARRA DEGUSTACION",30,30,0,0
CENTRO,"COMERCIO AL POR MENOR DE ALFOMBRAS, MOQUETAS Y REVESTIMIENTOS DE PAREDES Y SUELOS EN ESTABLECIMIENTOS ESPECIALIZADOS",7,8,14.285714285714285,1
CENTRO,COMERCIO AL POR MENOR DE APARATOS DE ILUMINACION,14,15,7.142857142857142,1
CENTRO,COMERCIO AL POR MENOR DE ARMAS,1,2,100,1
CENTRO,COMERCIO AL POR MENOR DE ARTICULOS DE FERRETERIA,52,46,-11.538461538461538,-6
CENTRO,COMERCIO AL POR MENOR DE ARTICULOS DE PERFUMERIA Y COSMETICA,82,93,13.414634146341465,11
CENTRO,COMERCIO AL POR MENOR DE ARTICULOS DE SEGUNDA MANO,171,203,18.71345029239766,32
CENTRO,COMERCIO AL POR MENOR DE ARTICULOS DE USO DOMESTICO EN ESTABLECIMIENTO ESPECIALIZADO,27,27,0,0
CENTRO,COMERCIO AL POR MENOR DE ARTICULOS DEPORTIVOS,30,41,36.666666666666664,11
CENTRO,COMERCIO AL POR MENOR DE ARTICULOS ORTOPEDICOS,6,4,-33.33333333333333,-2
CENTRO,"COMERCIO AL POR MENOR DE AVES, HUEVOS Y CAZA CON OBRADOR",4,12,200,8
CENTRO,"COMERCIO AL POR MENOR DE AVES, HUEVOS Y CAZA SIN OBRADOR",46,46,0,0
CENTRO,COMERCIO AL POR MENOR DE BACALAO Y SALAZONES,2,2,0,0
CENTRO,COMERCIO AL POR MENOR DE BICICLETAS,12,12,0,0
CENTRO,"COMERCIO AL POR MENOR DE CAFE, INFUSIONES Y CHOCOLATE",10,14,40,4
CENTRO,COMERCIO AL POR MENOR DE CALZADO Y ARTICULOS DE CUERO EN ESTABLECIMIENTOS ESPECIALIZADOS,194,199,2.5773195876288657,5
CENTRO,COMERCIO AL POR MENOR DE CARNICERIA,73,67,-8.21917808219178,-6
CENTRO,COMERCIO AL POR MENOR DE CARNICERIA-CHARCUTERIA,15,10,-33.33333333333333,-5
CENTRO,COMERCIO AL POR MENOR DE CARNICERIA-SALCHICHERIA,27,31,14.814814814814813,4
CENTRO,COMERCIO AL POR MENOR DE CASQUERIA,9,8,-11.11111111111111,-1
CENTRO,COMERCIO AL POR MENOR DE CHARCUTERIA,61,77,26.229508196721312,16
CENTRO,COMERCIO AL POR MENOR DE COMBUSTIBLE PARA LA AUTOMOCION EN ESTABLECIMIENTOS ESPECIALIZADOS,3,3,0,0
CENTRO,COMERCIO AL POR MENOR DE CONGELADOS,15,21,40,6
CENTRO,COMERCIO AL POR MENOR DE ELECTRODOMESTICOS,23,18,-21.73913043478261,-5
CENTRO,COMERCIO AL POR MENOR DE EQUIPOS O APARATOS AUDIOVISUALES,11,9,-18.181818181818183,-2
CENTRO,COMERCIO AL POR MENOR DE FRUTAS Y HORTALIZAS CON OBRADOR,13,24,84.61538461538461,11
CENTRO,COMERCIO AL POR MENOR DE FRUTAS Y HORTALIZAS SIN OBRADOR,155,163,5.161290322580645,8
CENTRO,COMERCIO AL POR MENOR DE FRUTOS SECOS Y VARIANTES,23,31,34.78260869565217,8
CENTRO,COMERCIO AL POR MENOR DE GOLOSINAS,21,16,-23.809523809523807,-5
CENTRO,COMERCIO AL POR MENOR DE HELADOS CON OBRADOR CON BARRA DE DEGUSTACION,13,17,30.76923076923077,4
CENTRO,COMERCIO AL POR MENOR DE HELADOS CON OBRADOR SIN BARRA DE DEGUSTACION,3,8,166.66666666666669,5
CENTRO,COMERCIO AL POR MENOR DE HELADOS SIN OBRADOR,16,26,62.5,10
CENTRO,COMERCIO AL POR MENOR DE INSTRUMENTOS MEDICOS Y ORTOPEDICOS,10,7,-30,-3
CENTRO,COMERCIO AL POR MENOR DE INSTRUMENTOS MUSICALES,22,22,0,0
CENTRO,"COMERCIO AL POR MENOR DE JOYAS, RELOJERIA Y BISUTERIA",220,203,-7.727272727272727,-17
CENTRO,COMERCIO AL POR MENOR DE JUEGOS Y JUGUETES,30,23,-23.333333333333332,-7
CENTRO,"COMERCIO AL POR MENOR DE LECHE, PRODUCTOS LACTEOS Y BEBIDAS REFRESCANTES",6,8,33.33333333333333,2
CENTRO,COMERCIO AL POR MENOR DE LIBROS,128,128,0,0
CENTRO,COMERCIO AL POR MENOR DE MAQUINARIA Y EQUIPOS DE OFICINA,1,1,0,0
CENTRO,"COMERCIO AL POR MENOR DE MASAS Y PATATAS FRITAS, CHURRERIA CON OBRADOR",7,12,71.42857142857143,5
CENTRO,"COMERCIO AL POR MENOR DE MASAS Y PATATAS FRITAS, CHURRERIA SIN OBRADOR",1,1,0,0
CENTRO,COMERCIO AL POR MENOR DE MATERIAL DE OPTICA,36,35,-2.7777777777777777,-1
CENTRO,COMERCIO AL POR MENOR DE MATERIAL ELECTRICO,6,9,50,3
CENTRO,COMERCIO AL POR MENOR DE MATERIAL ELECTRONICO,16,14,-12.5,-2
CENTRO,COMERCIO AL POR MENOR DE MATERIAL FOTOGRAFICO Y FOTOGRAFIA,15,18,20,3
CENTRO,COMERCIO AL POR MENOR DE MATERIALES DE CONSTRUCCION,10,10,0,0
CENTRO,COMERCIO AL POR MENOR DE MENAJE DEL HOGAR,16,17,6.25,1
CENTRO,COMERCIO AL POR MENOR DE MUEBLES,81,97,19.753086419753085,16
CENTRO,COMERCIO AL POR MENOR DE MUEBLES DE COCINA,4,7,75,3
CENTRO,COMERCIO AL POR MENOR DE PAN Y PRODUCTOS DE PANADERIA Y BOLLERIA CON OBRADOR,64,58,-9.375,-6
CENTRO,COMERCIO AL POR MENOR DE PAN Y PRODUCTOS DE PANADERIA Y BOLLERIA SIN OBRADOR,39,58,48.717948717948715,19
CENTRO,"COMERCIO AL POR MENOR DE PASTELERIA, CONFITERIA, REPOSTERIA CON OBRADOR-BARRA DEGUSTACION",51,74,45.09803921568628,23
CENTRO,"COMERCIO AL POR MENOR DE PASTELERIA, CONFITERIA, REPOSTERIA SIN OBRADOR",15,24,60,9
CENTRO,"COMERCIO AL POR MENOR DE PERIODICOS, REVISTAS Y ARTICULOS DE PAPELERIA",66,47,-28.78787878787879,-19
CENTRO,COMERCIO AL POR MENOR DE PESCADOS Y MARISCOS CON OBRADOR (INCLUYE COCCION),12,13,8.333333333333332,1
CENTRO,COMERCIO AL POR MENOR DE PESCADOS Y MARISCOS SIN OBRADOR,46,46,0,0
CENTRO,COMERCIO AL POR MENOR DE PRENDAS DE VESTIR EN ESTABLECIMIENTOS ESPECIALIZADOS,838,831,-0.8353221957040573,-7
CENTRO,COMERCIO AL POR MENOR DE PRODUCTOS ALIMENTICIOS NO PERECEDEROS ENVASADOS,91,125,37.362637362637365,34
CENTRO,"COMERCIO AL POR MENOR DE PRODUCTOS AUDIOVISUALES EN ESTABLECIMIENTOS ESPECIALIZADOS (CD,DVD,â¦)",15,14,-6.666666666666667,-1
CENTRO,COMERCIO AL POR MENOR DE PRODUCTOS DE DROGUERIA,33,31,-6.0606060606060606,-2
CENTRO,COMERCIO AL POR MENOR DE PRODUCTOS DE HERBOLARIO,38,39,2.631578947368421,1
CENTRO,"COMERCIO AL POR MENOR DE PRODUCTOS DE PRECIO UNICO, BAZARES Y ASIMILABLES",127,158,24.409448818897637,31
CENTRO,COMERCIO AL POR MENOR DE PRODUCTOS DE TELEFONIA Y TELECOMUNICACIONES,60,60,0,0
CENTRO,COMERCIO AL POR MENOR DE PRODUCTOS PARAFARMACEUTICOS,2,6,200,4
CENTRO,"COMERCIO AL POR MENOR DE PUERTAS, VENTANAS Y PERSIANAS",11,10,-9.090909090909092,-1
CENTRO,COMERCIO AL POR MENOR DE SANEAMIENTOS,6,6,0,0
CENTRO,"COMERCIO AL POR MENOR DE SELLOS, MONEDAS Y MEDALLAS",32,32,0,0
CENTRO,"COMERCIO AL POR MENOR DE SEMILLAS, ABONOS, PLANTAS Y FLOR CORTADA",42,44,4.761904761904762,2
CENTRO,COMERCIO AL POR MENOR DE TABACOS Y ARTICULOS DE FUMADOR,52,51,-1.9230769230769231,-1
CENTRO,COMERCIO AL POR MENOR DE TEXTILES PARA EL HOGAR,72,60,-16.666666666666664,-12
CENTRO,COMERCIO AL POR MENOR DE VINOS Y ALCOHOLES (BODEGA) CON CONSUMO,62,55,-11.29032258064516,-7
CENTRO,COMERCIO AL POR MENOR DE VINOS Y ALCOHOLES (BODEGA) SIN CONSUMO,34,41,20.588235294117645,7
CENTRO,"COMERCIO AL POR MENOR EN ESTABLECIMIENTOS NO ESPECIALIZADOS, CON PREDOMINIO EN PRODUCTOS ALIMENTICIOS, BEBIDAS Y TABACO (AUTOSERVICIO)",197,241,22.33502538071066,44
CENTRO,"COMERCIO AL POR MENOR EN ESTABLECIMIENTOS NO ESPECIALIZADOS, CON PREDOMINIO EN PRODUCTOS ALIMENTICIOS, BEBIDAS Y TABACO (GRANDES SUPERFICIES)",13,1,-92.3076923076923,-12
CENTRO,"COMERCIO AL POR MENOR EN ESTABLECIMIENTOS NO ESPECIALIZADOS, SIN PREDOMINIO EN PRODUCTOS ALIMENTICIOS, BEBIDAS Y TABACO",27,47,74.07407407407408,20
CENTRO,COMERCIO AL POR MENOR EN TIENDAS DE BRICOLAJE,3,5,66.66666666666666,2
CENTRO,"COMERCIO AL POR MENOR POR CORRESPONDENCIA, INTERNET, A DOMICILIO",5,12,140,7
CENTRO,COMERCIO DE RESPUESTOS Y ACCESORIOS DE VEHICULOS DE MOTOR,2,2,0,0
CENTRO,COMERCIO DE VEHICULOS DE MOTOR NUEVOS,4,4,0,0
CENTRO,COMERCIO DE VEHICULOS DE MOTOR USADOS,1,1,0,0
CENTRO,COMPRAVENTA DE BIENES INMOBILIARIOS POR CUENTA PROPIA,5,4,-20,-1
CENTRO,CONFECCION DE PRENDAS DE VESTIR DE PUNTO,2,2,0,0
CENTRO,CONFECCION PRENDAS DE VESTIR (INCLUIDO CUERO Y EXCLUIDA LA PELETERIA Y LAS PRENDAS DE PUNTO),30,28,-6.666666666666667,-2
CENTRO,CONSTRUCCION DE EDIFICIOS,12,8,-33.33333333333333,-4
CENTRO,CONSULTA DE ESTOMATOLOGOS Y ODONTOLOGOS,16,23,43.75,7
CENTRO,CONSULTA DE MEDICINA GENERAL Y ESPECIALIDADES,12,12,0,0
CENTRO,CONSULTA DE OPTICOS-OPTOMETRISTAS,4,5,25,1
CENTRO,CONSULTA DE PODOLOGIA,7,9,28.57142857142857,2
CENTRO,CONSULTA DE PROTESICOS E HIGIENISTAS DENTALES,8,9,12.5,1
CENTRO,CONSULTORIO VETERINARIO CON TRATAMIENTO HIGIENICO ANIMAL,5,4,-20,-1
CENTRO,DEPOSITO Y ALMACENAMIENTO,24,34,41.66666666666667,10
CENTRO,DESPACHO DE ESTOMATOLOGO Y ODONTOLOGO,3,2,-33.33333333333333,-1
CENTRO,DESPACHO DE FISIOTERAPEUTAS,3,6,100,3
CENTRO,DESPACHO DE OPTICOS-OPTOMETRISTAS,2,2,0,0
CENTRO,DESPACHO DE PODOLOGOS,2,2,0,0
CENTRO,"DESPACHO PROFESIONAL DE ACTIVIDADES ECONOMICAS (CONTABILIDAD, AUDITORIA Y ASESORIA FISCAL)",7,8,14.285714285714285,1
CENTRO,DESPACHO PROFESIONAL DE ACTIVIDADES JURIDICAS,2,2,0,0
CENTRO,DESPACHO PROFESIONAL DE ARQUITECTURA E INGENIERIA,11,11,0,0
CENTRO,DISCOTECAS Y SALAS DE BAILE,49,48,-2.0408163265306123,-1
CENTRO,"EDICION DE LIBROS, PERIODICOS Y OTRAS ACTIVIDADES EDITORIALES",14,13,-7.142857142857142,-1
CENTRO,EDUCACION TERCIARIA NO UNIVERSITARIA,3,2,-33.33333333333333,-1
CENTRO,EDUCACION UNIVERSITARIA PRIVADA,5,6,20,1
CENTRO,EDUCACION UNIVERSITARIA PUBLICA,9,8,-11.11111111111111,-1
CENTRO,ELABORACION DE HELADOS,2,2,0,0
CENTRO,ENCUADERNACION Y SERVICIOS RELACIONADOS CON LA MISMA,13,12,-7.6923076923076925,-1
CENTRO,ENSEÑANZA DE IDIOMAS,9,11,22.22222222222222,2
CENTRO,"ENSEÑANZA NO REGLADA (DEPORTIVA Y RECREATIVA, CULTURAL, CLASES DE RECUPERACION, INFORMATICA)",118,146,23.728813559322035,28
CENTRO,ESTABLECIMIENTOS DE VENTA DE PLATOS PREPARADOS CON OBRADOR,75,126,68,51
CENTRO,ESTABLECIMIENTOS DE VENTA DE PLATOS PREPARADOS SIN OBRADOR,29,34,17.24137931034483,5
CENTRO,EXPLOTACIONES AGRICOLAS,1,1,0,0
CENTRO,FABRICACION ARTICULOS DE FERRETERIA,1,1,0,0
CENTRO,"FABRICACION DE ARTICULOS DE JOYERIA, BISUTERIA Y SIMILARES",9,9,0,0
CENTRO,FABRICACION DE ARTICULOS DE PELETERIA,1,1,0,0
CENTRO,FABRICACION DE BEBIDAS,2,1,-50,-1
CENTRO,FABRICACION DE CALZADO,3,3,0,0
CENTRO,FABRICACION DE INSTRUMENTOS MUSICALES,14,13,-7.142857142857142,-1
CENTRO,FABRICACION DE INSTRUMENTOS Y SUMINISTROS MEDICOS Y ODONTOLOGICOS,3,4,33.33333333333333,1
CENTRO,FABRICACION DE MATERIAL Y EQUIPO ELECTRICO (EXCEPTO ORDENADORES),1,1,0,0
CENTRO,FABRICACION DE MUEBLES (INCLUIDOS COLCHONES),5,3,-40,-2
CENTRO,FABRICACION DE OTRO MATERIAL DE TRANSPORTE,1,1,0,0
CENTRO,FABRICACION DE PRODUCTOS DE CAUCHO Y PLASTICOS,3,3,0,0
CENTRO,FABRICACION DE PRODUCTOS DE PANADERIA Y PASTELERIA,5,6,20,1
CENTRO,"FABRICACION DE PRODUCTOS MINERALES NO METALICOS (HORMIGON, CEMENTO, MORTERO, CAL, YESO, LADRILLOS, CERAMICA)",1,2,100,1
CENTRO,"FABRICACION DE TEJIDOS TEXTILES, ALFOMBRAS, CUERDAS Y OTROS PRODUCTOS TEXTILES (EXCEPTO PRENDAS DE VESTIR)",4,2,-50,-2
CENTRO,FABRICACION DE VAJILLAS Y ARTICULOS PARA EL HOGAR,1,1,0,0
CENTRO,FABRICACION DE VIDRIO Y PRODUCTOS DERIVADOS,3,3,0,0
CENTRO,FABRICACION O ELABORACION DE OTROS PRODUCTOS ALIMENTICIOS N.C.O.P.,2,2,0,0
CENTRO,FARMACIA,114,116,1.7543859649122806,2
CENTRO,FISIOTERAPEUTAS Y OTRAS ACTIVIDADES SANITARIAS,15,17,13.333333333333334,2
CENTRO,GESTION DE INSTALACIONES DEPORTIVAS,2,1,-50,-1
CENTRO,HOSTALES,15,21,40,6
CENTRO,HOTELES Y MOTELES CON RESTAURANTE,101,109,7.920792079207921,8
CENTRO,HOTELES Y MOTELES SIN RESTAURANTE,21,26,23.809523809523807,5
CENTRO,IMPRENTA,24,21,-12.5,-3
CENTRO,"INDUSTRIA DE LA MADERA Y CORCHO (EXCEPTO MUEBLES), CESTERIA Y ESPARTERIA",13,14,7.6923076923076925,1
CENTRO,INDUSTRIA DEL PAPEL,1,1,0,0
CENTRO,INDUSTRIAS MANUFACTURERAS N.C.O.P.,4,5,25,1
CENTRO,INGENIERIA CIVIL,2,1,-50,-1
CENTRO,INSTALACION DE MAQUINAS Y EQUIPOS INDUSTRIALES,1,1,0,0
CENTRO,"INSTALACIONES ELECTRICAS, DE FONTANERIA Y OTRAS EN OBRAS DE CONSTRUCCION",54,53,-1.8518518518518516,-1
CENTRO,INSTITUTO DE BELLEZA,18,22,22.22222222222222,4
CENTRO,"INTERMEDIACION MONETARIA: BANCOS, CAJAS DE AHORRO",174,140,-19.54022988505747,-34
CENTRO,"INTERMEDIARIO DEL COMERCIO DE PRODUCTOS ALIMENTICIOS, BEBIDAS Y TABACO",1,2,100,1
CENTRO,INTERMEDIARIOS DEL COMERCIO DE MUEBLES,4,5,25,1
CENTRO,"INTERMEDIARIOS DEL COMERCIO DE TEXTILES, PRENDAS DE VESTIR, PELETERIA, CALZADO Y ARTICULOS DE CUERO",19,25,31.57894736842105,6
CENTRO,INTERMEDIARIOS DEL COMERCIO ESPECIALIZADOS EN LA VENTA DE OTROS PRODUCTOS ESPECIFICOS,4,3,-25,-1
CENTRO,INVESTIGACION Y DESARROLLO,1,1,0,0
CENTRO,"JUEGOS DE AZAR Y APUESTAS DE GESTION PRIVADA (BINGOS, CASINOS, MAQUINAS TRAGAPERRAS)",24,23,-4.166666666666666,-1
CENTRO,JUEGOS DE AZAR Y APUESTAS DE GESTION PUBLICA O O AUTORIZACION ESPECIAL (ESTADO Y ONCE),45,50,11.11111111111111,5
CENTRO,LAVADO Y LIMPIEZA DE PRENDAS TEXTILES Y DE PIEL,30,43,43.333333333333336,13
CENTRO,LOCAL SIN ACTIVIDAD,34,109,220.58823529411765,75
CENTRO,LOCALES DE EXHIBICIONES EROTICAS,3,2,-33.33333333333333,-1
CENTRO,LOCUTORIOS,100,90,-10,-10
CENTRO,"MANTENIMIENTO Y REPARACION DE MAQUINARIA Y EQUIPO, INCLUIDO EL FERROVIARIO",1,1,0,0
CENTRO,MANTENIMIENTO Y REPARACION DE MOTOCICLETAS Y VENTA DE SUS REPUESTOS Y ACCESORIOS,13,12,-7.6923076923076925,-1
CENTRO,MANTENIMIENTO Y REPARACION DE VEHICULOS DE MOTOR N.C.O.P.,4,4,0,0
CENTRO,ORGANIZACION DE CONVENCIONES Y FERIAS DE MUESTRAS,4,5,25,1
CENTRO,OTRAS ACTIVIDADES ASOCIATIVAS N.C.O.P.,71,90,26.76056338028169,19
CENTRO,"OTRAS ACTIVIDADES DE CONSTRUCCION ESPECIALIZADA (CONSTRUCCION DE CUBIERTAS, CIMENTACION, PISCINAS)",4,3,-25,-1
CENTRO,"OTRAS ACTIVIDADES PROFESIONALES, CIENTIFICAS Y TECNICAS N.C.O.P.",15,16,6.666666666666667,1
CENTRO,"OTRAS SERVICIOS PERSONALES (ASTROLOGIA, AGENCIAS DE CONTACTOS) N.C.O.P.",2,4,100,2
CENTRO,OTRO COMERCIO AL POR MENOR DE PRODUCTOS ALIMENTICIOS (PERECEDEROS Y NO PERECEDEROS) CON VENDEDOR N.C.O.P.,118,136,15.254237288135593,18
CENTRO,OTRO COMERCIO AL POR MENOR DEL ARTICULOS NUEVOS N.C.O.P.,194,219,12.886597938144329,25
CENTRO,OTROS ACTIVIDADES DE SERVICIOS SOCIALES (LABORES DE ASESORAMIENTO Y ORIENTACION) SIN ALOJAMIENTO N.C.O.P.,28,28,0,0
CENTRO,"OTROS SERVICIOS DE COMIDAS EN INSTALACIONES DEPORTIVAS, OFICINAS, EMPRESAS O SIMILARES",4,3,-25,-1
CENTRO,"OTROS SERVICIOS FINANCIEROS(ARRENDAMIENTO FINANCIERO, PRESTAMOS POR ENTIDADES NO FINANCIERAS), EXCEPTO SEGUROS Y FONDOS DE PENSIONES",3,2,-33.33333333333333,-1
CENTRO,PENSIONES,3,3,0,0
CENTRO,"PREPARACION, CURTIDO Y ACABADO DEL CUERO. FABRICACION DE ARTICULOS DE MARROQUINERIA, VIAJE, GUARNICIONERIA Y TALABARTERIA. PREPARACION Y TEÑIDO DE PIELES",11,12,9.090909090909092,1
CENTRO,PROCESADO Y CONSERVACION DE PLATOS PREPARADOS O PRECOCINADOS Y DIETETICOS,1,1,0,0
CENTRO,"PRODUCCION, TRANSPORTE Y DISTRIBUCION DE ENERGIA ELECTRICA Y GAS",1,1,0,0
CENTRO,PROGRAMACION Y CONSULTORIA INFORMATICA Y TECNOLOGIAS DE LA INFORMACION,7,8,14.285714285714285,1
CENTRO,PROMOCION INMOBILIARIA,10,10,0,0
CENTRO,"PUBLICIDAD, RELACIONES PUBLICAS Y ESTUDIOS DE MERCADO",33,34,3.0303030303030303,1
CENTRO,REASEGUROS,4,3,-25,-1
CENTRO,REPARACION DE BICICLETAS,2,2,0,0
CENTRO,REPARACION DE CALZADO,21,21,0,0
CENTRO,REPARACION DE ORDENADORES Y EQUIPOS DE COMUNICACION,4,9,125,5
CENTRO,REPARACION DE OTROS EFECTOS PERSONALES Y ARTICULOS DE USO DOMESTICO N.C.O.P.,49,42,-14.285714285714285,-7
CENTRO,REPRODUCCION DE SOPORTES GRABADOS,2,2,0,0
CENTRO,RESTAURANTE,737,724,-1.7639077340569878,-13
CENTRO,RESTAURANTES DE COMIDA RAPIDA,103,90,-12.62135922330097,-13
CENTRO,SALA DE EXPOSICIONES Y GALERIAS DE ARTE CON VENTA,76,79,3.9473684210526314,3
CENTRO,SALAS DE FIESTA CON RESTAURACION,2,5,150,3
CENTRO,SALAS DE FIESTA SIN RESTAURACION,8,10,25,2
CENTRO,SALONES DE BANQUETES Y PROVISION COMIDAS PARA EVENTOS,4,4,0,0
CENTRO,SALONES DE RECREO Y DIVERSION Y OTRAS ACTIVIDADES RECREATIVAS,14,14,0,0
CENTRO,SEGUROS,14,11,-21.428571428571427,-3
CENTRO,SERIGRAFIA Y SERVICIOS DE PREIMPRESION Y PREPARACION DE SOPORTES,6,8,33.33333333333333,2
CENTRO,SERVICIO DE PELUQUERIA,288,311,7.986111111111111,23
CENTRO,"SERVICIOS DE MENSAJERIA, ACTIVIDADES POSTALES Y DE CORREOS",22,22,0,0
CENTRO,SERVICIOS FOTOGRAFICOS,7,6,-14.285714285714285,-1
CENTRO,SERVICIOS INTEGRALES A EDIFICIOS E INSTALACIONES,3,5,66.66666666666666,2
CENTRO,"SERVICIOS PARASANITARIOS (NATUROPATIA, ACUPUNTURA, HOMEOPATIA)",9,7,-22.22222222222222,-2
CENTRO,SERVICIOS TECNICOS DE ARQUITECTURA E INGENIERIA. ENSAYOS Y ANALISIS TECNICOS,27,32,18.51851851851852,5
CENTRO,SEX-SHOP,13,9,-30.76923076923077,-4
CENTRO,SIN ASIGNAR,1,15,1400,14
CENTRO,"SITUADOS: COMPLEMENTOS, BISUTERIA Y ARTESANIA",7,13,85.71428571428571,6
CENTRO,TABERNA,79,73,-7.59493670886076,-6
CENTRO,TALLER DE MONTAJE DE ACCESORIOS PARA EL AUTOMOVIL,1,1,0,0
CENTRO,TALLER DE REPARACION DE AUTOMOVILES ESPECIALIZADO EN CHAPA Y PINTURA,11,10,-9.090909090909092,-1
CENTRO,TALLER DE REPARACION DE AUTOMOVILES ESPECIALIZADO EN MECANICA Y ELECTRICIDAD,7,8,14.285714285714285,1
CENTRO,TAPICERIA,11,9,-18.181818181818183,-2
CENTRO,TEATRO Y ACTIVIDADES ESCENICAS REALIZADAS EN DIRECTO,33,35,6.0606060606060606,2
CENTRO,TELECOMUNICACIONES,10,8,-20,-2
CENTRO,TIENDA DE CONVENIENCIA (24H),3,3,0,0
CENTRO,"TRANSPORTE TERRESTRE URBANO (AUTOBUS, METRO, TAXI) O INTERURBANO (EXCEPTO POR FERROCARRIL)",1,1,0,0
CENTRO,TRATAMIENTO HIGIENICO DE ANIMALES (PELUQUERIAS),10,7,-30,-3
CENTRO,VENDEDOR AMBULANTE DE ALIMENTOS PREPARADOS PARA SU CONSUMO INMEDIATO,2,2,0,0
CENTRO,VENTA DE MOTOCICLETAS,2,2,0,0
CENTRO,VIDEOCLUB,9,6,-33.33333333333333,-3
CENTRO,NA,13,16,23.076923076923077,3
USERA,"ACABADO DE EDIFICIOS (CARPINTERIA, REVOCAMIENTO, REVESTIMIENTO DE SUELOS Y PAREDES,  PINTURA, ACRISTALAMIENTO)",10,10,0,0
USERA,ACTIVIDADES ADMINISTRATIVAS Y AUXILIARES DE OFICINA Y SERVICIOS DE REPROGRAFIA,26,37,42.30769230769231,11
USERA,ACTIVIDADES ANEXAS AL TRANSPORTE,2,3,50,1
USERA,ACTIVIDADES AUXILIARES A SEGUROS Y FONDOS DE PENSIONES,6,5,-16.666666666666664,-1
USERA,"ACTIVIDADES CINEMATOGRAFICAS, DE VIDEO Y DE TELEVISION (PRODUCCION, DISTRIBUCION Y EXHIBICION)",2,2,0,0
USERA,"ACTIVIDADES DE APOYO A LAS EMPRESAS N.C.O.P. (AGENCIAS DE COBROS, ENVASADO Y EMPAQUETADO)",2,4,100,2
USERA,"ACTIVIDADES DE BIBLIOTECAS, ARCHIVOS, MUSEOS Y DE GALERIAS Y SALAS DE EXPOSICIONES SIN VENTA",9,9,0,0
USERA,ACTIVIDADES DE CLUBES DEPORTIVOS Y OTRAS ACTIVIDADES DEPORTIVAS,5,4,-20,-1
USERA,"ACTIVIDADES DE CONTABILIDAD, TENEDURIA, AUDITORIA Y ASESORIA FISCAL",28,25,-10.714285714285714,-3
USERA,ACTIVIDADES DE DISEÑO ESPECIALIZADO,1,1,0,0
USERA,ACTIVIDADES DE GRABACION DE SONIDO Y EDICION MUSICAL,1,1,0,0
USERA,ACTIVIDADES DE LAS SEDES CENTRALES,3,3,0,0
USERA,ACTIVIDADES DE LIMPIEZA,12,12,0,0
USERA,ACTIVIDADES DE LOS GIMNASIOS,7,10,42.857142857142854,3
USERA,ACTIVIDADES DE ORGANIZACIONES POLITICAS,4,4,0,0
USERA,ACTIVIDADES DE ORGANIZACIONES RELIGIOSAS,42,50,19.047619047619047,8
USERA,ACTIVIDADES DE PROGRAMACION Y EMISION DE RADIO Y TELEVISION,2,1,-50,-1
USERA,ACTIVIDADES DE SEGURIDAD PRIVADA,1,1,0,0
USERA,ACTIVIDADES DE SERVICIOS SOCIALES SIN ALOJAMIENTO PARA PERSONAS MAYORES Y DISCAPACITADOS,19,14,-26.31578947368421,-5
USERA,ACTIVIDADES HOSPITALARIAS,1,1,0,0
USERA,"ACTIVIDADES INMOBILIARIAS (COMPRAVENTA, ALQUILER, AGENTES PROPIEDAD)",13,21,61.53846153846154,8
USERA,ACTIVIDADES JURIDICAS,4,4,0,0
USERA,ADMINISTRACION PUBLICA Y DEFENSA. SEGURIDAD SOCIAL OBLIGATORIA,16,16,0,0
USERA,"AGENCIAS DE VIAJES,  OPERADORES TURISTICOS Y SERVICIOS DE RESERVAS",15,16,6.666666666666667,1
USERA,ALBERGUES JUVENILES Y OTROS ALOJAMIENTOS TURISTICOS DE CORTA ESTANCIA,1,1,0,0
USERA,ALMACEN DE DISTRIBUCION DE PRODUCTOS ALIMENTICIOS,2,3,50,1
USERA,ALQUILER DE BIENES INMOBILIARIOS POR CUENTA PROPIA,2,2,0,0
USERA,ALQUILER DE EFECTOS PERSONALES Y ARTICULOS DE USO DOMESTICO,2,1,-50,-1
USERA,ALQUILER DE VEHICULOS DE MOTOR,2,2,0,0
USERA,ALQUILER MAQUINARIA Y EQUIPO DE CONSTRUCCION,2,2,0,0
USERA,APARCAMIENTOS PRIVADOS,8,13,62.5,5
USERA,APARCAMIENTOS PUBLICOS,3,3,0,0
USERA,ARREGLO DE ROPA,17,18,5.88235294117647,1
USERA,"ASISTENCIA EN ESTABLECIMIENTOS RESIDENCIALES PARA MAYORES, DISCAPACITADOS, DROGODEPENDIENTES, CENTROS DE CONVALECENCIA, PERSONAS SIN HOGAR",29,29,0,0
USERA,AUTOESCUELA,23,23,0,0
USERA,AUTOSERVICIO DE RESTAURACION,1,1,0,0
USERA,BAR CON COCINA,214,218,1.8691588785046727,4
USERA,BAR ESPECIAL CON ACTUACIONES,3,4,33.33333333333333,1
USERA,BAR ESPECIAL SIN ACTUACIONES,31,26,-16.129032258064516,-5
USERA,BAR RESTAURANTE,100,115,15,15
USERA,BAR SIN COCINA,48,64,33.33333333333333,16
USERA,CAFETERIA,63,71,12.698412698412698,8
USERA,CAMBIO Y ENVIO DE MONEDA,9,8,-11.11111111111111,-1
USERA,CARPINTERIA Y EBANISTERIA,7,8,14.285714285714285,1
USERA,CENTRO DE EDUCACION DE PERSONAS ADULTAS (CEPA),3,4,33.33333333333333,1
USERA,CENTRO DE ESTETICA,26,44,69.23076923076923,18
USERA,CENTRO DE INFANTIL Y PRIMARIA PUBLICO,13,18,38.46153846153847,5
USERA,"CENTRO DE PRIMARIA, SECUNDARIA, BACHILLERATO Y/O FP PRIVADO",1,2,100,1
USERA,"CENTRO PRIV.CONCERTADO DE PRIMARIA, SECUND., BACHILL. Y/O FP",11,9,-18.181818181818183,-2
USERA,"CENTRO PUBLICO DE SECUNDARIA, BACHILLERATO Y/O FP",7,7,0,0
USERA,CENTROS DE BRONCEADO,12,11,-8.333333333333332,-1
USERA,CENTROS DE FOTODEPILACION,5,8,60,3
USERA,CENTROS DE JUEGOS O CELEBRACIONES INFANTILES CON COCINA,1,1,0,0
USERA,CENTROS DE JUEGOS O CELEBRACIONES INFANTILES SIN COCINA,2,5,150,3
USERA,CENTROS DE TATUAJE Y/O ANILLADO,4,6,50,2
USERA,CENTROS PRIVADOS CONCERTADOS EDUC INFANTIL Y EDUC PRIMARIA,10,8,-20,-2
USERA,CENTROS PUBLICOS DE EDUCACION PRIMARIA,4,4,0,0
USERA,CHOCOLATERIA/SALON DE TE Y HELADERIA,1,4,300,3
USERA,CLINICA VETERINARIA CON TRATAMIENTO HIGIENICO,3,4,33.33333333333333,1
USERA,CLINICA VETERINARIA SIN TRATAMIENTO HIGIENICO,1,1,0,0
USERA,CLINICAS MEDICAS,10,12,20,2
USERA,COMERCIO AL MAYOR CON ALMACEN,1,4,300,3
USERA,"COMERCIO AL POR MAYOR DE AZUCAR, CHOCOLATE Y CONFITERIA",1,1,0,0
USERA,COMERCIO AL POR MAYOR DE ENVASES Y EMBALAJES,1,1,0,0
USERA,COMERCIO AL POR MAYOR DE HUEVOS Y DERIVADOS,3,3,0,0
USERA,COMERCIO AL POR MAYOR DE INSTRUMENTOS MEDICOS Y ORTOPEDICOS,3,3,0,0
USERA,"COMERCIO AL POR MAYOR DE MAQUINARIA, EQUIPO DE  OFICINA Y SUMINISTROS",19,19,0,0
USERA,COMERCIO AL POR MAYOR DE MATERIAL Y APARATOS ELECTRONICOS PARA LAS TECNOLOGIAS DE LA INFORMACION Y LAS COMUNICACIONES,4,5,25,1
USERA,"COMERCIO AL POR MAYOR DE METALES FERREOS Y NO FERREOS, MATERIAL DE CONSTRUCCION, PAPEL Y CARTON",5,6,20,1
USERA,COMERCIO AL POR MAYOR DE MUEBLES,1,1,0,0
USERA,"COMERCIO AL POR MAYOR DE PERFUMERIA,COSMETICA, DROGUERIA Y LIMPIEZA",5,7,40,2
USERA,"COMERCIO AL POR MAYOR DE PRENDAS DE VESTIR, CALZADO Y ARTICULOS DE CUERO",7,6,-14.285714285714285,-1
USERA,COMERCIO AL POR MAYOR DE TEXTILES,5,6,20,1
USERA,"COMERCIO AL POR MAYOR FRUTAS, VERDURAS Y DERIVADOS",1,1,0,0
USERA,COMERCIO AL POR MENOR CON MAQUINAS EXPENDEDORAS,1,1,0,0
USERA,"COMERCIO AL POR MENOR DE  PASTELERIA, CONFITERIA, REPOSTERIA CON OBRADOR-SIN BARRA DEGUSTACION",12,17,41.66666666666667,5
USERA,"COMERCIO AL POR MENOR DE ALFOMBRAS, MOQUETAS Y REVESTIMIENTOS DE PAREDES Y SUELOS EN ESTABLECIMIENTOS ESPECIALIZADOS",4,5,25,1
USERA,COMERCIO AL POR MENOR DE APARATOS DE ILUMINACION,2,1,-50,-1
USERA,COMERCIO AL POR MENOR DE ARTICULOS DE FERRETERIA,20,17,-15,-3
USERA,COMERCIO AL POR MENOR DE ARTICULOS DE PERFUMERIA Y COSMETICA,27,33,22.22222222222222,6
USERA,COMERCIO AL POR MENOR DE ARTICULOS DE SEGUNDA MANO,13,12,-7.6923076923076925,-1
USERA,COMERCIO AL POR MENOR DE ARTICULOS DE USO DOMESTICO EN ESTABLECIMIENTO ESPECIALIZADO,12,8,-33.33333333333333,-4
USERA,COMERCIO AL POR MENOR DE ARTICULOS DEPORTIVOS,5,8,60,3
USERA,COMERCIO AL POR MENOR DE ARTICULOS ORTOPEDICOS,4,5,25,1
USERA,"COMERCIO AL POR MENOR DE AVES, HUEVOS Y CAZA CON OBRADOR",3,3,0,0
USERA,"COMERCIO AL POR MENOR DE AVES, HUEVOS Y CAZA SIN OBRADOR",28,34,21.428571428571427,6
USERA,COMERCIO AL POR MENOR DE BICICLETAS,3,4,33.33333333333333,1
USERA,"COMERCIO AL POR MENOR DE CAFE, INFUSIONES Y CHOCOLATE",2,4,100,2
USERA,COMERCIO AL POR MENOR DE CALZADO Y ARTICULOS DE CUERO EN ESTABLECIMIENTOS ESPECIALIZADOS,30,41,36.666666666666664,11
USERA,COMERCIO AL POR MENOR DE CARNICERIA,33,34,3.0303030303030303,1
USERA,COMERCIO AL POR MENOR DE CARNICERIA-CHARCUTERIA,20,28,40,8
USERA,COMERCIO AL POR MENOR DE CARNICERIA-SALCHICHERIA,5,17,240,12
USERA,COMERCIO AL POR MENOR DE CASQUERIA,10,11,10,1
USERA,COMERCIO AL POR MENOR DE CHARCUTERIA,33,34,3.0303030303030303,1
USERA,COMERCIO AL POR MENOR DE COLCHONERIA,3,2,-33.33333333333333,-1
USERA,COMERCIO AL POR MENOR DE COMBUSTIBLE PARA LA AUTOMOCION EN ESTABLECIMIENTOS ESPECIALIZADOS,4,5,25,1
USERA,COMERCIO AL POR MENOR DE CONGELADOS,13,11,-15.384615384615385,-2
USERA,COMERCIO AL POR MENOR DE ELECTRODOMESTICOS,4,3,-25,-1
USERA,COMERCIO AL POR MENOR DE EQUIPOS O APARATOS AUDIOVISUALES,1,3,200,2
USERA,COMERCIO AL POR MENOR DE FRUTAS Y HORTALIZAS SIN OBRADOR,99,96,-3.0303030303030303,-3
USERA,COMERCIO AL POR MENOR DE FRUTOS SECOS Y VARIANTES,24,23,-4.166666666666666,-1
USERA,COMERCIO AL POR MENOR DE GOLOSINAS,1,3,200,2
USERA,COMERCIO AL POR MENOR DE HELADOS CON OBRADOR CON BARRA DE DEGUSTACION,1,3,200,2
USERA,COMERCIO AL POR MENOR DE HELADOS SIN OBRADOR,2,4,100,2
USERA,COMERCIO AL POR MENOR DE INSTRUMENTOS MEDICOS Y ORTOPEDICOS,1,1,0,0
USERA,"COMERCIO AL POR MENOR DE JOYAS, RELOJERIA Y BISUTERIA",25,34,36,9
USERA,COMERCIO AL POR MENOR DE JUEGOS Y JUGUETES,4,5,25,1
USERA,"COMERCIO AL POR MENOR DE LECHE, PRODUCTOS LACTEOS Y BEBIDAS REFRESCANTES",6,5,-16.666666666666664,-1
USERA,COMERCIO AL POR MENOR DE LIBROS,3,5,66.66666666666666,2
USERA,COMERCIO AL POR MENOR DE MAQUINARIA Y EQUIPOS DE OFICINA,5,4,-20,-1
USERA,"COMERCIO AL POR MENOR DE MASAS Y PATATAS FRITAS, CHURRERIA CON OBRADOR",8,7,-12.5,-1
USERA,COMERCIO AL POR MENOR DE MATERIAL DE OPTICA,20,24,20,4
USERA,COMERCIO AL POR MENOR DE MATERIAL ELECTRICO,6,4,-33.33333333333333,-2
USERA,COMERCIO AL POR MENOR DE MATERIAL ELECTRONICO,11,13,18.181818181818183,2
USERA,COMERCIO AL POR MENOR DE MATERIAL FOTOGRAFICO Y FOTOGRAFIA,10,9,-10,-1
USERA,COMERCIO AL POR MENOR DE MATERIALES DE CONSTRUCCION,2,3,50,1
USERA,COMERCIO AL POR MENOR DE MENAJE DEL HOGAR,2,4,100,2
USERA,COMERCIO AL POR MENOR DE MUEBLES,11,12,9.090909090909092,1
USERA,COMERCIO AL POR MENOR DE MUEBLES DE COCINA,7,7,0,0
USERA,COMERCIO AL POR MENOR DE PAN Y PRODUCTOS DE PANADERIA Y BOLLERIA CON OBRADOR,27,30,11.11111111111111,3
USERA,COMERCIO AL POR MENOR DE PAN Y PRODUCTOS DE PANADERIA Y BOLLERIA SIN OBRADOR,16,17,6.25,1
USERA,"COMERCIO AL POR MENOR DE PASTELERIA, CONFITERIA, REPOSTERIA CON OBRADOR-BARRA DEGUSTACION",10,17,70,7
USERA,"COMERCIO AL POR MENOR DE PASTELERIA, CONFITERIA, REPOSTERIA SIN OBRADOR",3,5,66.66666666666666,2
USERA,"COMERCIO AL POR MENOR DE PERIODICOS, REVISTAS Y ARTICULOS DE PAPELERIA",23,24,4.3478260869565215,1
USERA,COMERCIO AL POR MENOR DE PESCADOS Y MARISCOS SIN OBRADOR,34,32,-5.88235294117647,-2
USERA,COMERCIO AL POR MENOR DE PRENDAS DE VESTIR EN ESTABLECIMIENTOS ESPECIALIZADOS,106,149,40.56603773584906,43
USERA,COMERCIO AL POR MENOR DE PRODUCTOS ALIMENTICIOS NO PERECEDEROS ENVASADOS,14,31,121.42857142857142,17
USERA,COMERCIO AL POR MENOR DE PRODUCTOS DE DROGUERIA,15,15,0,0
USERA,COMERCIO AL POR MENOR DE PRODUCTOS DE HERBOLARIO,16,19,18.75,3
USERA,"COMERCIO AL POR MENOR DE PRODUCTOS DE PRECIO UNICO, BAZARES Y ASIMILABLES",51,59,15.686274509803921,8
USERA,COMERCIO AL POR MENOR DE PRODUCTOS DE TELEFONIA Y TELECOMUNICACIONES,22,24,9.090909090909092,2
USERA,COMERCIO AL POR MENOR DE PRODUCTOS PARAFARMACEUTICOS,5,8,60,3
USERA,"COMERCIO AL POR MENOR DE PUERTAS, VENTANAS Y PERSIANAS",7,8,14.285714285714285,1
USERA,COMERCIO AL POR MENOR DE SANEAMIENTOS,9,9,0,0
USERA,"COMERCIO AL POR MENOR DE SEMILLAS, ABONOS, PLANTAS Y FLOR CORTADA",7,9,28.57142857142857,2
USERA,COMERCIO AL POR MENOR DE TABACOS Y ARTICULOS DE FUMADOR,20,20,0,0
USERA,COMERCIO AL POR MENOR DE TEXTILES PARA EL HOGAR,15,16,6.666666666666667,1
USERA,COMERCIO AL POR MENOR DE VINOS Y ALCOHOLES (BODEGA) CON CONSUMO,1,2,100,1
USERA,COMERCIO AL POR MENOR DE VINOS Y ALCOHOLES (BODEGA) SIN CONSUMO,5,4,-20,-1
USERA,"COMERCIO AL POR MENOR EN ESTABLECIMIENTOS NO ESPECIALIZADOS, CON PREDOMINIO EN PRODUCTOS ALIMENTICIOS, BEBIDAS Y TABACO (AUTOSERVICIO)",76,93,22.36842105263158,17
USERA,"COMERCIO AL POR MENOR EN ESTABLECIMIENTOS NO ESPECIALIZADOS, CON PREDOMINIO EN PRODUCTOS ALIMENTICIOS, BEBIDAS Y TABACO (GRANDES SUPERFICIES)",2,4,100,2
USERA,"COMERCIO AL POR MENOR EN ESTABLECIMIENTOS NO ESPECIALIZADOS, SIN PREDOMINIO EN PRODUCTOS ALIMENTICIOS, BEBIDAS Y TABACO",6,10,66.66666666666666,4
USERA,COMERCIO AL POR MENOR EN TIENDAS DE BRICOLAJE,4,4,0,0
USERA,"COMERCIO AL POR MENOR POR CORRESPONDENCIA, INTERNET, A DOMICILIO",2,3,50,1
USERA,COMERCIO DE RESPUESTOS Y ACCESORIOS DE VEHICULOS DE MOTOR,15,15,0,0
USERA,COMERCIO DE VEHICULOS DE MOTOR NUEVOS,10,5,-50,-5
USERA,COMERCIO DE VEHICULOS DE MOTOR USADOS,9,9,0,0
USERA,CONFECCION DE PRENDAS DE VESTIR DE PUNTO,4,3,-25,-1
USERA,CONFECCION PRENDAS DE VESTIR (INCLUIDO CUERO Y EXCLUIDA LA PELETERIA Y LAS PRENDAS DE PUNTO),32,34,6.25,2
USERA,CONSTRUCCION DE EDIFICIOS,21,20,-4.761904761904762,-1
USERA,CONSULTA DE ESTOMATOLOGOS Y ODONTOLOGOS,25,29,16,4
USERA,CONSULTA DE MEDICINA GENERAL Y ESPECIALIDADES,9,8,-11.11111111111111,-1
USERA,CONSULTA DE OPTICOS-OPTOMETRISTAS,2,3,50,1
USERA,CONSULTA DE PODOLOGIA,3,5,66.66666666666666,2
USERA,CONSULTA DE PROTESICOS E HIGIENISTAS DENTALES,2,3,50,1
USERA,CONSULTORIO VETERINARIO CON TRATAMIENTO HIGIENICO ANIMAL,2,3,50,1
USERA,"CORTE, TALLADO Y ACABADO DE LA PIEDRA",1,1,0,0
USERA,DEPOSITO Y ALMACENAMIENTO,57,66,15.789473684210526,9
USERA,DESPACHO DE FISIOTERAPEUTAS,1,1,0,0
USERA,DESPACHO MEDICO DE MEDICINA GENERAL Y ESPECIALISTAS,2,2,0,0
USERA,DESPACHO PROFESIONAL DE ACTIVIDADES JURIDICAS,2,4,100,2
USERA,DISCOTECAS Y SALAS DE BAILE,5,5,0,0
USERA,"EDICION DE LIBROS, PERIODICOS Y OTRAS ACTIVIDADES EDITORIALES",2,2,0,0
USERA,EDUCACION TERCIARIA NO UNIVERSITARIA,3,4,33.33333333333333,1
USERA,ENSEÑANZA DE IDIOMAS,8,9,12.5,1
USERA,"ENSEÑANZA NO REGLADA (DEPORTIVA Y RECREATIVA, CULTURAL, CLASES DE RECUPERACION, INFORMATICA)",26,33,26.923076923076923,7
USERA,ESTABLECIMIENTOS DE VENTA DE PLATOS PREPARADOS CON OBRADOR,21,20,-4.761904761904762,-1
USERA,EXPLOTACIONES AGRICOLAS,1,1,0,0
USERA,FABRICACION ARTICULOS DE FERRETERIA,3,3,0,0
USERA,"FABRICACION DE ARTICULOS DE JOYERIA, BISUTERIA Y SIMILARES",8,7,-12.5,-1
USERA,FABRICACION DE ARTICULOS DE PELETERIA,2,2,0,0
USERA,FABRICACION DE CALZADO,1,1,0,0
USERA,FABRICACION DE COMPONENTES ELECTRONICOS Y CIRCUITOS IMPRESOS ENSAMBLADOS,2,2,0,0
USERA,FABRICACION DE INSTRUMENTOS Y SUMINISTROS MEDICOS Y ODONTOLOGICOS,4,4,0,0
USERA,"FABRICACION DE JABONES, DETERGENTES Y OTROS ARTICULOS DE LIMPIEZA. PERFUMES Y COSMETICOS",1,1,0,0
USERA,FABRICACION DE JUEGOS Y JUGUETES,1,1,0,0
USERA,FABRICACION DE MATERIAL Y EQUIPO ELECTRICO (EXCEPTO ORDENADORES),5,6,20,1
USERA,FABRICACION DE MUEBLES (INCLUIDOS COLCHONES),5,4,-20,-1
USERA,"FABRICACION DE PASTAS ALIMENTICIAS,CUSCUS Y SIMILARES",1,1,0,0
USERA,FABRICACION DE PRODUCTOS DE CAUCHO Y PLASTICOS,2,2,0,0
USERA,FABRICACION DE PRODUCTOS DE PANADERIA Y PASTELERIA,1,3,200,2
USERA,"FABRICACION DE PRODUCTOS METALICOS, EXCEPTO MAQUINARIA Y EQUIPO",24,22,-8.333333333333332,-2
USERA,"FABRICACION DE PRODUCTOS MINERALES NO METALICOS (HORMIGON, CEMENTO, MORTERO, CAL, YESO, LADRILLOS, CERAMICA)",1,1,0,0
USERA,"FABRICACION DE TEJIDOS TEXTILES, ALFOMBRAS, CUERDAS Y OTROS PRODUCTOS TEXTILES (EXCEPTO PRENDAS DE VESTIR)",3,2,-33.33333333333333,-1
USERA,FABRICACION O ELABORACION DE OTROS PRODUCTOS ALIMENTICIOS N.C.O.P.,3,4,33.33333333333333,1
USERA,FARMACIA,64,66,3.125,2
USERA,FISIOTERAPEUTAS Y OTRAS ACTIVIDADES SANITARIAS,12,15,25,3
USERA,GESTION DE INSTALACIONES DEPORTIVAS,6,7,16.666666666666664,1
USERA,HOSTALES,1,2,100,1
USERA,HOTELES Y MOTELES CON RESTAURANTE,1,1,0,0
USERA,IMPRENTA,14,14,0,0
USERA,INDUSTRIA DEL PAPEL,2,2,0,0
USERA,INDUSTRIAS MANUFACTURERAS N.C.O.P.,4,4,0,0
USERA,INGENIERIA CIVIL,3,3,0,0
USERA,INSTALACION DE MAQUINAS Y EQUIPOS INDUSTRIALES,4,4,0,0
USERA,"INSTALACIONES ELECTRICAS, DE FONTANERIA Y OTRAS EN OBRAS DE CONSTRUCCION",88,83,-5.681818181818182,-5
USERA,INSTITUTO DE BELLEZA,13,15,15.384615384615385,2
USERA,"INTERMEDIACION MONETARIA: BANCOS, CAJAS DE AHORRO",55,48,-12.727272727272727,-7
USERA,"INTERMEDIARIO DEL COMERCIO DE PRODUCTOS ALIMENTICIOS, BEBIDAS Y TABACO",1,2,100,1
USERA,"INTERMEDIARIOS DEL COMERCIO DE TEXTILES, PRENDAS DE VESTIR, PELETERIA, CALZADO Y ARTICULOS DE CUERO",2,4,100,2
USERA,INTERMEDIARIOS DEL COMERCIO ESPECIALIZADOS EN LA VENTA DE OTROS PRODUCTOS ESPECIFICOS,5,5,0,0
USERA,"JUEGOS DE AZAR Y APUESTAS DE GESTION PRIVADA (BINGOS, CASINOS, MAQUINAS TRAGAPERRAS)",5,23,360,18
USERA,JUEGOS DE AZAR Y APUESTAS DE GESTION PUBLICA O O AUTORIZACION ESPECIAL (ESTADO Y ONCE),19,19,0,0
USERA,LAVADO Y LIMPIEZA DE PRENDAS TEXTILES Y DE PIEL,12,16,33.33333333333333,4
USERA,LOCAL SIN ACTIVIDAD,4,18,350,14
USERA,LOCUTORIOS,83,71,-14.457831325301203,-12
USERA,"MANTENIMIENTO Y REPARACION DE MAQUINARIA Y EQUIPO, INCLUIDO EL FERROVIARIO",4,4,0,0
USERA,MANTENIMIENTO Y REPARACION DE MOTOCICLETAS Y VENTA DE SUS REPUESTOS Y ACCESORIOS,5,5,0,0
USERA,MANTENIMIENTO Y REPARACION DE VEHICULOS DE MOTOR N.C.O.P.,19,19,0,0
USERA,OTRAS ACTIVIDADES ASOCIATIVAS N.C.O.P.,21,26,23.809523809523807,5
USERA,"OTRAS ACTIVIDADES DE CONSTRUCCION ESPECIALIZADA (CONSTRUCCION DE CUBIERTAS, CIMENTACION, PISCINAS)",17,15,-11.76470588235294,-2
USERA,"OTRAS ACTIVIDADES PROFESIONALES, CIENTIFICAS Y TECNICAS N.C.O.P.",2,3,50,1
USERA,OTRO COMERCIO AL POR MENOR DE PRODUCTOS ALIMENTICIOS (PERECEDEROS Y NO PERECEDEROS) CON VENDEDOR N.C.O.P.,153,157,2.6143790849673203,4
USERA,OTRO COMERCIO AL POR MENOR DEL ARTICULOS NUEVOS N.C.O.P.,15,16,6.666666666666667,1
USERA,OTROS ACTIVIDADES DE SERVICIOS SOCIALES (LABORES DE ASESORAMIENTO Y ORIENTACION) SIN ALOJAMIENTO N.C.O.P.,10,11,10,1
USERA,"OTROS SERVICIOS DE COMIDAS EN INSTALACIONES DEPORTIVAS, OFICINAS, EMPRESAS O SIMILARES",7,7,0,0
USERA,"OTROS SERVICIOS FINANCIEROS(ARRENDAMIENTO FINANCIERO, PRESTAMOS POR ENTIDADES NO FINANCIERAS), EXCEPTO SEGUROS Y FONDOS DE PENSIONES",2,2,0,0
USERA,"PREPARACION, CURTIDO Y ACABADO DEL CUERO. FABRICACION DE ARTICULOS DE MARROQUINERIA, VIAJE, GUARNICIONERIA Y TALABARTERIA. PREPARACION Y TEÑIDO DE PIELES",2,3,50,1
USERA,PROCESADO Y CONSERVACION DE LECHE Y DERIVADOS,1,1,0,0
USERA,PROCESADO Y CONSERVACION DE PLATOS PREPARADOS O PRECOCINADOS Y DIETETICOS,1,1,0,0
USERA,"PRODUCCION, TRANSPORTE Y DISTRIBUCION DE ENERGIA ELECTRICA Y GAS",5,5,0,0
USERA,PROGRAMACION Y CONSULTORIA INFORMATICA Y TECNOLOGIAS DE LA INFORMACION,7,7,0,0
USERA,PROMOCION INMOBILIARIA,11,11,0,0
USERA,"PUBLICIDAD, RELACIONES PUBLICAS Y ESTUDIOS DE MERCADO",5,5,0,0
USERA,"RECOGIDA, TRATAMIENTO Y ELIMINACION DE RESIDUOS. VALORIZACION (PROCESOS DE RECUPERACION)",1,1,0,0
USERA,RECUBRIMIENTOS METALICOS (TRATAMIENTO Y REVESTIMIENTO DE METALES),2,2,0,0
USERA,REPARACION DE BICICLETAS,1,2,100,1
USERA,REPARACION DE CALZADO,13,16,23.076923076923077,3
USERA,REPARACION DE ORDENADORES Y EQUIPOS DE COMUNICACION,10,9,-10,-1
USERA,REPARACION DE OTROS EFECTOS PERSONALES Y ARTICULOS DE USO DOMESTICO N.C.O.P.,13,12,-7.6923076923076925,-1
USERA,REPRODUCCION DE SOPORTES GRABADOS,1,1,0,0
USERA,RESTAURANTE,33,53,60.60606060606061,20
USERA,RESTAURANTES DE COMIDA RAPIDA,11,12,9.090909090909092,1
USERA,SALONES DE BANQUETES Y PROVISION COMIDAS PARA EVENTOS,4,5,25,1
USERA,SALONES DE RECREO Y DIVERSION Y OTRAS ACTIVIDADES RECREATIVAS,5,4,-20,-1
USERA,SEGUROS,11,10,-9.090909090909092,-1
USERA,SERIGRAFIA Y SERVICIOS DE PREIMPRESION Y PREPARACION DE SOPORTES,6,6,0,0
USERA,SERVICIO DE PELUQUERIA,181,202,11.602209944751381,21
USERA,"SERVICIOS DE MENSAJERIA, ACTIVIDADES POSTALES Y DE CORREOS",15,20,33.33333333333333,5
USERA,SERVICIOS FOTOGRAFICOS,6,7,16.666666666666664,1
USERA,SERVICIOS INTEGRALES A EDIFICIOS E INSTALACIONES,2,2,0,0
USERA,"SERVICIOS PARASANITARIOS (NATUROPATIA, ACUPUNTURA, HOMEOPATIA)",3,7,133.33333333333331,4
USERA,SERVICIOS TECNICOS DE ARQUITECTURA E INGENIERIA. ENSAYOS Y ANALISIS TECNICOS,4,4,0,0
USERA,SEX-SHOP,2,2,0,0
USERA,SITUADOS: HELADOS Y/O BEBIDAS REFRESCANTES,1,1,0,0
USERA,TABERNA,5,4,-20,-1
USERA,TALLER DE MONTAJE DE ACCESORIOS PARA EL AUTOMOVIL,3,5,66.66666666666666,2
USERA,TALLER DE REPARACION DE AUTOMOVILES ESPECIALIZADO EN CHAPA Y PINTURA,32,35,9.375,3
USERA,TALLER DE REPARACION DE AUTOMOVILES ESPECIALIZADO EN MECANICA Y ELECTRICIDAD,86,92,6.976744186046512,6
USERA,TAPICERIA,6,6,0,0
USERA,TEATRO Y ACTIVIDADES ESCENICAS REALIZADAS EN DIRECTO,2,1,-50,-1
USERA,TELECOMUNICACIONES,5,5,0,0
USERA,TIENDA DE CONVENIENCIA (24H),3,3,0,0
USERA,TRANSPORTE DE MERCANCIAS POR CARRETERA Y SERVICIOS DE MUDANZAS,8,8,0,0
USERA,TRATAMIENTO HIGIENICO DE ANIMALES (PELUQUERIAS),3,3,0,0
USERA,VENTA DE MOTOCICLETAS,2,2,0,0
USERA,NA,1,7,600,6
